Date & Time,Charleville Mall,Charleville Mall IN,Charleville Mall OUT,Grove Road Totem,OUT,IN,Guild Street,Guild Street bikes IN-Towards Quays,Guild Street bikes OUT-Towards Drumcondra,North Strand Rd N/B,North Strand Rd S/B
Wed 1 Jan 2020 00:00,0,0,0,12,6,6,5,4,1,13,8
Wed 1 Jan 2020 01:00,1,1,0,13,5,8,4,0,4,10,2
Wed 1 Jan 2020 02:00,2,1,1,16,12,4,5,1,4,13,6
Wed 1 Jan 2020 03:00,3,2,1,15,7,8,2,2,0,13,5
Wed 1 Jan 2020 04:00,1,1,0,18,16,2,1,1,0,11,1
Wed 1 Jan 2020 05:00,1,0,1,14,9,5,3,2,1,8,2
Wed 1 Jan 2020 06:00,0,0,0,19,6,13,9,9,0,8,10
Wed 1 Jan 2020 07:00,0,0,0,18,4,14,15,12,3,8,9
Wed 1 Jan 2020 08:00,0,0,0,18,7,11,12,11,1,10,11
Wed 1 Jan 2020 09:00,1,0,1,26,3,23,10,9,1,6,14
Wed 1 Jan 2020 10:00,1,1,0,31,13,18,17,12,5,7,17
Wed 1 Jan 2020 11:00,1,0,1,38,11,27,15,11,4,17,24
Wed 1 Jan 2020 12:00,0,0,0,51,22,29,14,14,0,20,22
Wed 1 Jan 2020 13:00,1,1,0,48,20,28,28,20,8,25,14
Wed 1 Jan 2020 14:00,3,2,1,45,11,34,25,15,10,26,32
Wed 1 Jan 2020 15:00,1,1,0,48,20,28,21,19,2,22,25
Wed 1 Jan 2020 16:00,4,3,1,42,21,21,32,20,12,28,19
Wed 1 Jan 2020 17:00,0,0,0,45,23,22,26,18,8,31,18
Wed 1 Jan 2020 18:00,1,0,1,49,25,24,16,10,6,21,15
Wed 1 Jan 2020 19:00,0,0,0,37,23,14,18,9,9,20,8
Wed 1 Jan 2020 20:00,0,0,0,32,20,12,12,6,6,19,12
Wed 1 Jan 2020 21:00,1,1,0,37,22,15,8,6,2,17,10
Wed 1 Jan 2020 22:00,0,0,0,22,17,5,14,9,5,14,3
Wed 1 Jan 2020 23:00,1,1,0,9,6,3,4,1,3,13,5
Thu 2 Jan 2020 00:00,0,0,0,12,9,3,1,1,0,4,2
Thu 2 Jan 2020 01:00,0,0,0,3,2,1,0,0,0,7,3
Thu 2 Jan 2020 02:00,0,0,0,2,2,0,0,0,0,1,1
Thu 2 Jan 2020 03:00,0,0,0,4,3,1,2,2,0,3,0
Thu 2 Jan 2020 04:00,0,0,0,10,3,7,8,8,0,0,7
Thu 2 Jan 2020 05:00,0,0,0,21,1,20,13,11,2,5,15
Thu 2 Jan 2020 06:00,6,5,1,87,11,76,60,57,3,10,59
Thu 2 Jan 2020 07:00,4,3,1,189,30,159,91,82,9,21,93
Thu 2 Jan 2020 08:00,13,13,0,424,47,377,153,142,11,24,185
Thu 2 Jan 2020 09:00,6,5,1,199,20,179,72,64,8,19,105
Thu 2 Jan 2020 10:00,2,0,2,71,22,49,27,20,7,12,33
Thu 2 Jan 2020 11:00,1,0,1,48,17,31,33,25,8,14,34
Thu 2 Jan 2020 12:00,4,3,1,56,22,34,29,22,7,19,31
Thu 2 Jan 2020 13:00,1,1,0,46,17,29,25,15,10,19,19
Thu 2 Jan 2020 14:00,2,0,2,52,29,23,33,17,16,33,21
Thu 2 Jan 2020 15:00,0,0,0,66,36,30,36,19,17,42,28
Thu 2 Jan 2020 16:00,8,4,4,187,107,80,56,25,31,112,27
Thu 2 Jan 2020 17:00,7,4,3,356,268,88,108,40,68,266,34
Thu 2 Jan 2020 18:00,4,1,3,215,140,75,48,21,27,142,17
Thu 2 Jan 2020 19:00,4,2,2,85,55,30,29,11,18,61,21
Thu 2 Jan 2020 20:00,5,5,0,52,32,20,21,6,15,36,15
Thu 2 Jan 2020 21:00,1,0,1,35,26,9,10,3,7,36,10
Thu 2 Jan 2020 22:00,1,1,0,33,19,14,21,8,13,32,1
Thu 2 Jan 2020 23:00,3,1,2,23,17,6,11,3,8,14,5
Fri 3 Jan 2020 00:00,2,0,2,16,15,1,3,0,3,11,2
Fri 3 Jan 2020 01:00,2,0,2,9,4,5,1,0,1,9,1
Fri 3 Jan 2020 02:00,0,0,0,6,3,3,0,0,0,2,0
Fri 3 Jan 2020 03:00,0,0,0,4,2,2,2,2,0,3,0
Fri 3 Jan 2020 04:00,0,0,0,9,3,6,7,7,0,3,4
Fri 3 Jan 2020 05:00,1,1,0,20,2,18,14,13,1,4,18
Fri 3 Jan 2020 06:00,5,5,0,76,9,67,53,51,2,8,58
Fri 3 Jan 2020 07:00,6,4,2,197,26,171,91,85,6,22,102
Fri 3 Jan 2020 08:00,22,20,2,438,40,398,159,150,9,25,255
Fri 3 Jan 2020 09:00,7,7,0,229,26,203,89,78,11,22,126
Fri 3 Jan 2020 10:00,2,2,0,65,16,49,20,15,5,19,34
Fri 3 Jan 2020 11:00,6,5,1,67,20,47,36,34,2,12,30
Fri 3 Jan 2020 12:00,6,3,3,74,26,48,43,29,14,35,61
Fri 3 Jan 2020 13:00,4,3,1,84,35,49,45,25,20,49,54
Fri 3 Jan 2020 14:00,7,5,2,88,37,51,41,23,18,47,43
Fri 3 Jan 2020 15:00,3,2,1,120,62,58,37,21,16,75,41
Fri 3 Jan 2020 16:00,3,2,1,192,126,66,66,34,32,138,37
Fri 3 Jan 2020 17:00,9,3,6,322,247,75,120,41,79,219,43
Fri 3 Jan 2020 18:00,2,0,2,208,135,73,69,34,35,160,22
Fri 3 Jan 2020 19:00,7,3,4,104,65,39,40,21,19,58,14
Fri 3 Jan 2020 20:00,2,1,1,73,49,24,20,6,14,45,10
Fri 3 Jan 2020 21:00,5,4,1,40,27,13,18,10,8,40,5
Fri 3 Jan 2020 22:00,0,0,0,41,28,13,16,7,9,34,6
Fri 3 Jan 2020 23:00,1,1,0,31,26,5,11,2,9,20,6
Sat 4 Jan 2020 00:00,0,0,0,25,17,8,9,3,6,13,6
Sat 4 Jan 2020 01:00,1,1,0,11,7,4,1,1,0,14,3
Sat 4 Jan 2020 02:00,0,0,0,7,7,0,0,0,0,16,2
Sat 4 Jan 2020 03:00,2,2,0,6,4,2,0,0,0,6,1
Sat 4 Jan 2020 04:00,1,0,1,7,2,5,2,2,0,5,5
Sat 4 Jan 2020 05:00,1,0,1,15,3,12,6,6,0,4,9
Sat 4 Jan 2020 06:00,0,0,0,33,4,29,16,16,0,6,13
Sat 4 Jan 2020 07:00,2,1,1,33,8,25,17,14,3,9,19
Sat 4 Jan 2020 08:00,1,1,0,63,13,50,19,19,0,15,26
Sat 4 Jan 2020 09:00,1,1,0,62,14,48,26,20,6,12,30
Sat 4 Jan 2020 10:00,3,2,1,61,27,34,33,28,5,7,44
Sat 4 Jan 2020 11:00,1,1,0,70,19,51,31,22,9,16,29
Sat 4 Jan 2020 12:00,6,3,3,85,33,52,45,31,14,25,40
Sat 4 Jan 2020 13:00,3,3,0,71,29,42,36,21,15,39,35
Sat 4 Jan 2020 14:00,8,5,3,88,32,56,27,21,6,50,41
Sat 4 Jan 2020 15:00,4,1,3,86,39,47,23,18,5,32,39
Sat 4 Jan 2020 16:00,7,3,4,73,26,47,42,28,14,41,29
Sat 4 Jan 2020 17:00,1,0,1,110,50,60,29,20,9,52,17
Sat 4 Jan 2020 18:00,5,4,1,78,35,43,29,18,11,49,13
Sat 4 Jan 2020 19:00,2,0,2,81,41,40,17,14,3,41,22
Sat 4 Jan 2020 20:00,3,2,1,90,31,59,21,7,14,36,28
Sat 4 Jan 2020 21:00,2,2,0,26,12,14,10,6,4,26,4
Sat 4 Jan 2020 22:00,1,1,0,34,29,5,16,8,8,22,6
Sat 4 Jan 2020 23:00,1,1,0,24,20,4,11,4,7,26,9
Sun 5 Jan 2020 00:00,0,0,0,24,16,8,10,2,8,16,5
Sun 5 Jan 2020 01:00,3,0,3,11,6,5,1,0,1,12,3
Sun 5 Jan 2020 02:00,0,0,0,8,6,2,0,0,0,9,0
Sun 5 Jan 2020 03:00,1,0,1,6,4,2,3,2,1,7,3
Sun 5 Jan 2020 04:00,0,0,0,9,3,6,1,1,0,5,2
Sun 5 Jan 2020 05:00,0,0,0,6,3,3,4,4,0,4,7
Sun 5 Jan 2020 06:00,0,0,0,24,3,21,11,10,1,5,13
Sun 5 Jan 2020 07:00,0,0,0,30,4,26,14,12,2,5,16
Sun 5 Jan 2020 08:00,0,0,0,39,10,29,9,9,0,13,14
Sun 5 Jan 2020 09:00,1,1,0,35,8,27,22,18,4,13,23
Sun 5 Jan 2020 10:00,2,1,1,63,17,46,18,11,7,21,33
Sun 5 Jan 2020 11:00,6,6,0,57,12,45,35,26,9,25,36
Sun 5 Jan 2020 12:00,6,3,3,95,51,44,32,21,11,44,32
Sun 5 Jan 2020 13:00,2,1,1,78,38,40,36,24,12,44,39
Sun 5 Jan 2020 14:00,8,4,4,67,35,32,27,19,8,28,23
Sun 5 Jan 2020 15:00,2,1,1,86,40,46,41,25,16,38,39
Sun 5 Jan 2020 16:00,0,0,0,99,40,59,39,28,11,27,41
Sun 5 Jan 2020 17:00,3,2,1,70,29,41,21,11,10,35,22
Sun 5 Jan 2020 18:00,3,2,1,51,25,26,21,12,9,29,20
Sun 5 Jan 2020 19:00,1,1,0,71,42,29,20,11,9,24,7
Sun 5 Jan 2020 20:00,2,1,1,47,23,24,30,14,16,28,5
Sun 5 Jan 2020 21:00,2,1,1,32,23,9,16,8,8,16,4
Sun 5 Jan 2020 22:00,0,0,0,24,18,6,13,6,7,24,6
Sun 5 Jan 2020 23:00,0,0,0,26,19,7,4,1,3,15,2
Mon 6 Jan 2020 00:00,1,1,0,9,8,1,0,0,0,9,2
Mon 6 Jan 2020 01:00,0,0,0,7,6,1,0,0,0,5,2
Mon 6 Jan 2020 02:00,0,0,0,4,4,0,0,0,0,5,3
Mon 6 Jan 2020 03:00,0,0,0,3,1,2,3,3,0,3,1
Mon 6 Jan 2020 04:00,0,0,0,10,3,7,6,6,0,4,3
Mon 6 Jan 2020 05:00,1,1,0,32,3,29,14,13,1,1,29
Mon 6 Jan 2020 06:00,6,6,0,131,15,116,120,116,4,11,80
Mon 6 Jan 2020 07:00,14,12,2,387,50,337,151,140,11,35,183
Mon 6 Jan 2020 08:00,29,26,3,872,87,785,312,287,25,57,364
Mon 6 Jan 2020 09:00,17,16,1,263,27,236,133,123,10,19,168
Mon 6 Jan 2020 10:00,2,2,0,55,13,42,29,28,1,9,33
Mon 6 Jan 2020 11:00,3,1,2,44,13,31,22,20,2,8,29
Mon 6 Jan 2020 12:00,1,1,0,78,34,44,31,19,12,31,26
Mon 6 Jan 2020 13:00,6,4,2,78,34,44,36,24,12,45,48
Mon 6 Jan 2020 14:00,4,4,0,73,39,34,47,23,24,52,31
Mon 6 Jan 2020 15:00,5,1,4,112,73,39,48,22,26,44,32
Mon 6 Jan 2020 16:00,12,5,7,203,137,66,76,29,47,171,57
Mon 6 Jan 2020 17:00,18,9,9,542,432,110,171,62,109,408,61
Mon 6 Jan 2020 18:00,8,4,4,446,349,97,107,34,73,360,24
Mon 6 Jan 2020 19:00,2,1,1,149,106,43,34,12,22,110,16
Mon 6 Jan 2020 20:00,4,4,0,110,78,32,26,10,16,66,5
Mon 6 Jan 2020 21:00,3,1,2,59,47,12,12,3,9,43,4
Mon 6 Jan 2020 22:00,3,0,3,45,31,14,19,7,12,40,6
Mon 6 Jan 2020 23:00,1,0,1,18,17,1,9,1,8,23,4
Tue 7 Jan 2020 00:00,2,1,1,7,5,2,3,1,2,12,3
Tue 7 Jan 2020 01:00,2,0,2,3,2,1,1,1,0,5,1
Tue 7 Jan 2020 02:00,0,0,0,8,4,4,1,0,1,4,1
Tue 7 Jan 2020 03:00,0,0,0,4,1,3,2,2,0,3,1
Tue 7 Jan 2020 04:00,0,0,0,8,3,5,9,9,0,5,6
Tue 7 Jan 2020 05:00,2,1,1,37,5,32,20,19,1,3,25
Tue 7 Jan 2020 06:00,11,9,2,134,19,115,109,107,2,12,86
Tue 7 Jan 2020 07:00,8,7,1,416,51,365,172,154,18,38,190
Tue 7 Jan 2020 08:00,27,24,3,894,87,807,330,309,21,56,404
Tue 7 Jan 2020 09:00,18,14,4,343,30,313,154,139,15,20,242
Tue 7 Jan 2020 10:00,0,0,0,87,21,66,40,33,7,12,60
Tue 7 Jan 2020 11:00,0,0,0,68,24,44,34,30,4,11,37
Tue 7 Jan 2020 12:00,0,0,0,81,35,46,38,23,15,45,34
Tue 7 Jan 2020 13:00,0,0,0,78,31,47,47,32,15,49,40
Tue 7 Jan 2020 14:00,2,2,0,69,35,34,52,35,17,51,34
Tue 7 Jan 2020 15:00,3,3,0,113,69,44,44,22,22,62,28
Tue 7 Jan 2020 16:00,6,3,3,239,158,81,79,31,48,198,43
Tue 7 Jan 2020 17:00,20,6,14,532,434,98,175,49,126,447,62
Tue 7 Jan 2020 18:00,6,2,4,437,355,82,146,43,103,354,28
Tue 7 Jan 2020 19:00,6,2,4,176,129,47,65,23,42,115,17
Tue 7 Jan 2020 20:00,6,5,1,103,66,37,37,15,22,62,13
Tue 7 Jan 2020 21:00,1,0,1,83,64,19,15,8,7,53,10
Tue 7 Jan 2020 22:00,0,0,0,48,31,17,19,8,11,26,11
Tue 7 Jan 2020 23:00,1,0,1,19,14,5,16,6,10,20,3
Wed 8 Jan 2020 00:00,1,0,1,13,10,3,2,1,1,9,2
Wed 8 Jan 2020 01:00,3,1,2,3,2,1,3,3,0,7,1
Wed 8 Jan 2020 02:00,0,0,0,10,8,2,0,0,0,6,1
Wed 8 Jan 2020 03:00,0,0,0,6,3,3,3,1,2,4,0
Wed 8 Jan 2020 04:00,0,0,0,11,3,8,6,6,0,4,5
Wed 8 Jan 2020 05:00,0,0,0,32,6,26,18,17,1,4,24
Wed 8 Jan 2020 06:00,4,4,0,149,21,128,119,115,4,11,87
Wed 8 Jan 2020 07:00,13,12,1,441,58,383,181,162,19,39,215
Wed 8 Jan 2020 08:00,39,34,5,1001,109,892,361,339,22,62,563
Wed 8 Jan 2020 09:00,14,11,3,400,45,355,171,149,22,19,226
Wed 8 Jan 2020 10:00,1,1,0,102,15,87,32,25,7,20,54
Wed 8 Jan 2020 11:00,0,0,0,66,22,44,39,33,6,11,30
Wed 8 Jan 2020 12:00,3,2,1,91,37,54,36,21,15,42,45
Wed 8 Jan 2020 13:00,1,0,1,108,41,67,58,35,23,48,54
Wed 8 Jan 2020 14:00,2,2,0,97,49,48,40,27,13,58,35
Wed 8 Jan 2020 15:00,1,1,0,135,85,50,53,25,28,68,53
Wed 8 Jan 2020 16:00,4,3,1,262,169,93,80,37,43,179,53
Wed 8 Jan 2020 17:00,25,11,14,560,448,112,220,66,154,451,63
Wed 8 Jan 2020 18:00,15,5,10,484,386,98,140,46,94,420,29
Wed 8 Jan 2020 19:00,6,3,3,206,155,51,40,14,26,159,21
Wed 8 Jan 2020 20:00,0,0,0,109,75,34,40,21,19,76,8
Wed 8 Jan 2020 21:00,3,3,0,72,52,20,29,4,25,55,12
Wed 8 Jan 2020 22:00,1,0,1,51,41,10,16,4,12,35,11
Wed 8 Jan 2020 23:00,1,1,0,32,24,8,21,7,14,24,4
Thu 9 Jan 2020 00:00,0,0,0,8,6,2,4,3,1,12,0
Thu 9 Jan 2020 01:00,0,0,0,2,1,1,0,0,0,5,0
Thu 9 Jan 2020 02:00,0,0,0,4,3,1,0,0,0,1,0
Thu 9 Jan 2020 03:00,0,0,0,4,1,3,3,2,1,4,1
Thu 9 Jan 2020 04:00,0,0,0,13,3,10,8,8,0,5,9
Thu 9 Jan 2020 05:00,0,0,0,29,3,26,18,17,1,4,18
Thu 9 Jan 2020 06:00,9,8,1,155,17,138,121,119,2,17,85
Thu 9 Jan 2020 07:00,13,10,3,399,60,339,165,153,12,37,199
Thu 9 Jan 2020 08:00,35,33,2,959,105,854,316,291,25,54,455
Thu 9 Jan 2020 09:00,22,19,3,379,36,343,167,147,20,22,251
Thu 9 Jan 2020 10:00,2,1,1,99,16,83,40,36,4,14,59
Thu 9 Jan 2020 11:00,1,0,1,58,18,40,26,16,10,12,42
Thu 9 Jan 2020 12:00,3,2,1,96,42,54,46,30,16,51,50
Thu 9 Jan 2020 13:00,4,2,2,88,36,52,34,24,10,38,37
Thu 9 Jan 2020 14:00,11,7,4,80,44,36,46,33,13,55,41
Thu 9 Jan 2020 15:00,9,7,2,119,85,34,56,29,27,61,35
Thu 9 Jan 2020 16:00,9,7,2,229,144,85,81,45,36,177,52
Thu 9 Jan 2020 17:00,19,8,11,566,434,132,164,55,109,372,56
Thu 9 Jan 2020 18:00,12,3,9,474,379,95,154,44,110,338,48
Thu 9 Jan 2020 19:00,5,1,4,188,143,45,57,27,30,146,27
Thu 9 Jan 2020 20:00,4,3,1,121,89,32,34,13,21,101,13
Thu 9 Jan 2020 21:00,4,3,1,69,48,21,32,14,18,62,12
Thu 9 Jan 2020 22:00,3,2,1,72,47,25,22,4,18,39,10
Thu 9 Jan 2020 23:00,3,1,2,35,29,6,16,3,13,34,3
Fri 10 Jan 2020 00:00,1,0,1,15,11,4,1,0,1,19,2
Fri 10 Jan 2020 01:00,0,0,0,11,8,3,0,0,0,6,2
Fri 10 Jan 2020 02:00,1,0,1,6,4,2,1,1,0,6,0
Fri 10 Jan 2020 03:00,0,0,0,2,1,1,1,1,0,2,1
Fri 10 Jan 2020 04:00,2,1,1,14,6,8,2,2,0,10,5
Fri 10 Jan 2020 05:00,1,1,0,32,5,27,22,19,3,4,23
Fri 10 Jan 2020 06:00,7,7,0,144,16,128,111,109,2,14,71
Fri 10 Jan 2020 07:00,8,6,2,339,44,295,150,135,15,28,151
Fri 10 Jan 2020 08:00,35,32,3,761,79,682,301,275,26,57,379
Fri 10 Jan 2020 09:00,14,12,2,343,30,313,148,131,17,22,177
Fri 10 Jan 2020 10:00,1,0,1,89,23,66,28,25,3,29,48
Fri 10 Jan 2020 11:00,4,3,1,63,17,46,48,38,10,21,40
Fri 10 Jan 2020 12:00,1,1,0,92,42,50,34,25,9,44,63
Fri 10 Jan 2020 13:00,4,2,2,118,39,79,44,23,21,74,22
Fri 10 Jan 2020 14:00,0,0,0,101,60,41,42,22,20,60,33
Fri 10 Jan 2020 15:00,6,5,1,117,74,43,47,23,24,88,33
Fri 10 Jan 2020 16:00,6,2,4,252,174,78,74,31,43,149,37
Fri 10 Jan 2020 17:00,9,5,4,459,372,87,147,47,100,359,59
Fri 10 Jan 2020 18:00,8,4,4,329,262,67,101,46,55,255,31
Fri 10 Jan 2020 19:00,2,1,1,144,100,44,50,20,30,96,17
Fri 10 Jan 2020 20:00,3,1,2,99,65,34,32,13,19,77,6
Fri 10 Jan 2020 21:00,7,4,3,59,40,19,36,11,25,40,7
Fri 10 Jan 2020 22:00,4,3,1,59,33,26,21,8,13,29,5
Fri 10 Jan 2020 23:00,1,1,0,40,32,8,15,2,13,25,2
Sat 11 Jan 2020 00:00,1,1,0,29,22,7,9,2,7,19,4
Sat 11 Jan 2020 01:00,0,0,0,23,16,7,3,0,3,12,1
Sat 11 Jan 2020 02:00,1,1,0,7,6,1,2,0,2,13,3
Sat 11 Jan 2020 03:00,3,0,3,7,6,1,0,0,0,8,0
Sat 11 Jan 2020 04:00,0,0,0,10,3,7,2,1,1,6,2
Sat 11 Jan 2020 05:00,0,0,0,14,3,11,11,11,0,5,6
Sat 11 Jan 2020 06:00,1,0,1,38,14,24,26,25,1,3,20
Sat 11 Jan 2020 07:00,0,0,0,47,13,34,37,32,5,14,14
Sat 11 Jan 2020 08:00,2,2,0,62,12,50,25,24,1,7,18
Sat 11 Jan 2020 09:00,3,3,0,68,16,52,17,13,4,11,27
Sat 11 Jan 2020 10:00,3,2,1,43,11,32,20,17,3,13,13
Sat 11 Jan 2020 11:00,4,1,3,50,18,32,25,18,7,11,18
Sat 11 Jan 2020 12:00,2,0,2,49,19,30,23,18,5,20,15
Sat 11 Jan 2020 13:00,3,2,1,55,31,24,12,9,3,23,5
Sat 11 Jan 2020 14:00,0,0,0,36,19,17,18,11,7,14,10
Sat 11 Jan 2020 15:00,1,0,1,57,22,35,16,11,5,24,10
Sat 11 Jan 2020 16:00,2,2,0,54,24,30,26,17,9,19,10
Sat 11 Jan 2020 17:00,0,0,0,93,42,51,15,10,5,35,17
Sat 11 Jan 2020 18:00,2,2,0,89,34,55,17,8,9,23,14
Sat 11 Jan 2020 19:00,1,0,1,56,24,32,14,9,5,19,6
Sat 11 Jan 2020 20:00,4,3,1,41,22,19,14,4,10,20,8
Sat 11 Jan 2020 21:00,1,1,0,38,21,17,10,8,2,17,6
Sat 11 Jan 2020 22:00,1,1,0,31,26,5,12,6,6,16,4
Sat 11 Jan 2020 23:00,0,0,0,27,16,11,13,3,10,21,5
Sun 12 Jan 2020 00:00,1,1,0,23,13,10,5,2,3,11,4
Sun 12 Jan 2020 01:00,0,0,0,16,6,10,2,0,2,3,2
Sun 12 Jan 2020 02:00,0,0,0,12,9,3,2,1,1,7,3
Sun 12 Jan 2020 03:00,0,0,0,10,2,8,0,0,0,2,0
Sun 12 Jan 2020 04:00,0,0,0,5,2,3,0,0,0,2,1
Sun 12 Jan 2020 05:00,1,1,0,6,1,5,6,6,0,4,7
Sun 12 Jan 2020 06:00,1,0,1,29,9,20,13,13,0,6,15
Sun 12 Jan 2020 07:00,0,0,0,35,6,29,18,16,2,12,15
Sun 12 Jan 2020 08:00,0,0,0,45,9,36,20,17,3,6,23
Sun 12 Jan 2020 09:00,0,0,0,62,16,46,23,15,8,15,22
Sun 12 Jan 2020 10:00,3,2,1,74,29,45,24,15,9,21,19
Sun 12 Jan 2020 11:00,6,2,4,72,22,50,37,31,6,27,35
Sun 12 Jan 2020 12:00,4,4,0,113,49,64,53,38,15,33,42
Sun 12 Jan 2020 13:00,3,2,1,113,34,79,40,30,10,36,21
Sun 12 Jan 2020 14:00,1,1,0,77,33,44,37,28,9,41,39
Sun 12 Jan 2020 15:00,2,1,1,91,37,54,37,22,15,35,35
Sun 12 Jan 2020 16:00,1,1,0,82,43,39,29,17,12,28,34
Sun 12 Jan 2020 17:00,7,2,5,88,41,47,33,22,11,37,25
Sun 12 Jan 2020 18:00,5,3,2,89,50,39,30,17,13,48,13
Sun 12 Jan 2020 19:00,3,1,2,66,40,26,26,11,15,34,6
Sun 12 Jan 2020 20:00,2,0,2,53,28,25,11,8,3,24,4
Sun 12 Jan 2020 21:00,0,0,0,34,17,17,14,8,6,16,7
Sun 12 Jan 2020 22:00,2,1,1,34,29,5,11,5,6,20,4
Sun 12 Jan 2020 23:00,3,0,3,19,15,4,7,2,5,15,3
Mon 13 Jan 2020 00:00,0,0,0,15,11,4,7,5,2,7,2
Mon 13 Jan 2020 01:00,0,0,0,1,1,0,1,1,0,4,3
Mon 13 Jan 2020 02:00,0,0,0,3,2,1,1,0,1,1,0
Mon 13 Jan 2020 03:00,0,0,0,5,1,4,1,1,0,6,0
Mon 13 Jan 2020 04:00,0,0,0,6,1,5,6,6,0,3,7
Mon 13 Jan 2020 05:00,1,0,1,28,4,24,18,16,2,2,16
Mon 13 Jan 2020 06:00,5,5,0,136,14,122,116,112,4,13,67
Mon 13 Jan 2020 07:00,15,11,4,364,59,305,152,144,8,28,177
Mon 13 Jan 2020 08:00,36,34,2,749,73,676,302,280,22,57,363
Mon 13 Jan 2020 09:00,12,12,0,328,41,287,133,121,12,31,183
Mon 13 Jan 2020 10:00,5,4,1,61,13,48,25,20,5,13,37
Mon 13 Jan 2020 11:00,3,3,0,58,25,33,15,11,4,12,23
Mon 13 Jan 2020 12:00,3,1,2,53,32,21,25,22,3,29,20
Mon 13 Jan 2020 13:00,3,1,2,40,23,17,24,14,10,17,15
Mon 13 Jan 2020 14:00,2,2,0,45,27,18,21,11,10,24,10
Mon 13 Jan 2020 15:00,4,3,1,71,42,29,34,16,18,51,22
Mon 13 Jan 2020 16:00,11,4,7,195,135,60,69,37,32,133,44
Mon 13 Jan 2020 17:00,10,4,6,383,311,72,129,44,85,284,57
Mon 13 Jan 2020 18:00,10,1,9,358,305,53,108,39,69,307,28
Mon 13 Jan 2020 19:00,2,2,0,127,99,28,38,19,19,80,9
Mon 13 Jan 2020 20:00,3,2,1,76,63,13,27,11,16,45,4
Mon 13 Jan 2020 21:00,4,3,1,54,43,11,17,9,8,27,9
Mon 13 Jan 2020 22:00,3,3,0,42,27,15,21,4,17,27,5
Mon 13 Jan 2020 23:00,2,1,1,18,13,5,7,1,6,15,4
Tue 14 Jan 2020 00:00,1,1,0,9,6,3,2,1,1,10,0
Tue 14 Jan 2020 01:00,0,0,0,3,2,1,1,1,0,1,3
Tue 14 Jan 2020 02:00,0,0,0,6,5,1,0,0,0,5,0
Tue 14 Jan 2020 03:00,1,0,1,6,1,5,1,1,0,4,1
Tue 14 Jan 2020 04:00,0,0,0,7,1,6,7,7,0,3,6
Tue 14 Jan 2020 05:00,0,0,0,27,3,24,16,15,1,5,14
Tue 14 Jan 2020 06:00,9,9,0,145,22,123,132,130,2,14,70
Tue 14 Jan 2020 07:00,15,14,1,395,48,347,162,153,9,24,166
Tue 14 Jan 2020 08:00,39,37,2,912,90,822,355,326,29,56,353
Tue 14 Jan 2020 09:00,16,14,2,336,33,303,153,138,15,31,217
Tue 14 Jan 2020 10:00,2,2,0,62,15,47,33,27,6,11,51
Tue 14 Jan 2020 11:00,2,1,1,42,17,25,26,22,4,16,33
Tue 14 Jan 2020 12:00,0,0,0,67,23,44,27,17,10,34,40
Tue 14 Jan 2020 13:00,4,3,1,92,35,57,33,18,15,36,33
Tue 14 Jan 2020 14:00,4,4,0,79,37,42,33,21,12,44,27
Tue 14 Jan 2020 15:00,2,1,1,121,65,56,55,26,29,66,34
Tue 14 Jan 2020 16:00,12,5,7,230,149,81,93,48,45,189,42
Tue 14 Jan 2020 17:00,9,3,6,529,420,109,170,50,120,428,69
Tue 14 Jan 2020 18:00,9,3,6,491,396,95,140,45,95,345,23
Tue 14 Jan 2020 19:00,9,5,4,186,134,52,68,30,38,133,9
Tue 14 Jan 2020 20:00,4,1,3,132,91,41,42,13,29,79,20
Tue 14 Jan 2020 21:00,5,2,3,75,57,18,25,9,16,37,8
Tue 14 Jan 2020 22:00,3,3,0,63,46,17,27,10,17,41,5
Tue 14 Jan 2020 23:00,3,1,2,28,19,9,14,5,9,33,2
Wed 15 Jan 2020 00:00,1,1,0,16,11,5,5,2,3,9,5
Wed 15 Jan 2020 01:00,0,0,0,3,2,1,2,2,0,3,0
Wed 15 Jan 2020 02:00,0,0,0,2,1,1,1,1,0,4,0
Wed 15 Jan 2020 03:00,0,0,0,5,1,4,2,2,0,9,0
Wed 15 Jan 2020 04:00,0,0,0,10,3,7,8,8,0,6,3
Wed 15 Jan 2020 05:00,1,0,1,28,5,23,23,21,2,4,20
Wed 15 Jan 2020 06:00,5,5,0,133,22,111,130,126,4,13,65
Wed 15 Jan 2020 07:00,11,11,0,425,54,371,188,170,18,31,195
Wed 15 Jan 2020 08:00,43,39,4,948,94,854,338,314,24,53,397
Wed 15 Jan 2020 09:00,21,19,2,368,31,337,186,164,22,21,219
Wed 15 Jan 2020 10:00,2,0,2,93,21,72,42,38,4,7,39
Wed 15 Jan 2020 11:00,1,1,0,75,19,56,32,27,5,15,32
Wed 15 Jan 2020 12:00,6,4,2,101,33,68,38,28,10,37,39
Wed 15 Jan 2020 13:00,4,3,1,112,44,68,40,26,14,57,57
Wed 15 Jan 2020 14:00,7,6,1,110,56,54,43,30,13,58,29
Wed 15 Jan 2020 15:00,4,2,2,109,63,46,43,20,23,79,37
Wed 15 Jan 2020 16:00,5,4,1,243,152,91,103,52,51,175,45
Wed 15 Jan 2020 17:00,14,3,11,518,427,91,165,60,105,451,93
Wed 15 Jan 2020 18:00,7,4,3,467,364,103,137,35,102,323,38
Wed 15 Jan 2020 19:00,4,2,2,178,126,52,70,27,43,123,13
Wed 15 Jan 2020 20:00,0,0,0,119,76,43,34,15,19,70,8
Wed 15 Jan 2020 21:00,3,1,2,81,59,22,28,9,19,35,8
Wed 15 Jan 2020 22:00,2,2,0,67,45,22,22,8,14,38,5
Wed 15 Jan 2020 23:00,1,1,0,27,22,5,13,3,10,30,6
Thu 16 Jan 2020 00:00,0,0,0,12,8,4,4,0,4,15,1
Thu 16 Jan 2020 01:00,0,0,0,4,4,0,1,1,0,9,2
Thu 16 Jan 2020 02:00,0,0,0,5,2,3,0,0,0,3,0
Thu 16 Jan 2020 03:00,1,0,1,5,1,4,1,1,0,7,0
Thu 16 Jan 2020 04:00,0,0,0,7,2,5,8,8,0,3,7
Thu 16 Jan 2020 05:00,0,0,0,36,5,31,20,18,2,6,17
Thu 16 Jan 2020 06:00,5,5,0,150,24,126,132,128,4,13,80
Thu 16 Jan 2020 07:00,10,9,1,418,58,360,165,152,13,30,159
Thu 16 Jan 2020 08:00,38,35,3,935,94,841,326,308,18,56,407
Thu 16 Jan 2020 09:00,11,8,3,395,51,344,147,130,17,18,226
Thu 16 Jan 2020 10:00,1,1,0,104,20,84,26,22,4,14,45
Thu 16 Jan 2020 11:00,5,3,2,48,15,33,24,23,1,6,23
Thu 16 Jan 2020 12:00,6,6,0,75,35,40,34,23,11,22,22
Thu 16 Jan 2020 13:00,3,1,2,85,41,44,33,21,12,31,29
Thu 16 Jan 2020 14:00,1,1,0,86,37,49,36,26,10,48,37
Thu 16 Jan 2020 15:00,6,2,4,134,68,66,57,27,30,70,33
Thu 16 Jan 2020 16:00,11,7,4,234,151,83,86,42,44,151,32
Thu 16 Jan 2020 17:00,10,5,5,527,416,111,136,52,84,305,29
Thu 16 Jan 2020 18:00,18,8,10,440,330,110,143,33,110,273,29
Thu 16 Jan 2020 19:00,3,2,1,199,137,62,57,18,39,155,30
Thu 16 Jan 2020 20:00,3,0,3,122,86,36,46,23,23,93,21
Thu 16 Jan 2020 21:00,0,0,0,88,58,30,18,6,12,38,4
Thu 16 Jan 2020 22:00,0,0,0,65,51,14,32,15,17,33,7
Thu 16 Jan 2020 23:00,1,0,1,30,25,5,18,6,12,27,3
Fri 17 Jan 2020 00:00,1,0,1,20,14,6,6,0,6,12,4
Fri 17 Jan 2020 01:00,1,1,0,11,9,2,3,2,1,8,3
Fri 17 Jan 2020 02:00,0,0,0,7,4,3,1,1,0,6,0
Fri 17 Jan 2020 03:00,0,0,0,9,5,4,2,1,1,4,0
Fri 17 Jan 2020 04:00,1,0,1,9,4,5,4,4,0,4,6
Fri 17 Jan 2020 05:00,1,1,0,27,3,24,25,22,3,4,22
Fri 17 Jan 2020 06:00,3,3,0,141,17,124,133,130,3,10,63
Fri 17 Jan 2020 07:00,9,9,0,337,51,286,153,140,13,32,187
Fri 17 Jan 2020 08:00,27,27,0,819,81,738,310,292,18,52,388
Fri 17 Jan 2020 09:00,19,18,1,329,35,294,155,128,27,32,206
Fri 17 Jan 2020 10:00,5,5,0,89,18,71,44,38,6,14,48
Fri 17 Jan 2020 11:00,6,5,1,63,19,44,38,24,14,29,31
Fri 17 Jan 2020 12:00,1,0,1,93,41,52,35,19,16,53,38
Fri 17 Jan 2020 13:00,6,4,2,136,64,72,54,30,24,68,41
Fri 17 Jan 2020 14:00,5,4,1,116,55,61,48,31,17,47,33
Fri 17 Jan 2020 15:00,10,5,5,136,75,61,44,19,25,70,44
Fri 17 Jan 2020 16:00,11,5,6,288,190,98,88,34,54,136,43
Fri 17 Jan 2020 17:00,12,4,8,439,349,90,155,58,97,362,46
Fri 17 Jan 2020 18:00,6,3,3,352,269,83,124,42,82,241,35
Fri 17 Jan 2020 19:00,6,3,3,156,97,59,55,17,38,114,7
Fri 17 Jan 2020 20:00,2,1,1,98,59,39,30,15,15,58,23
Fri 17 Jan 2020 21:00,3,1,2,73,44,29,20,4,16,39,7
Fri 17 Jan 2020 22:00,2,1,1,39,31,8,17,6,11,33,7
Fri 17 Jan 2020 23:00,1,0,1,40,27,13,15,8,7,34,0
Sat 18 Jan 2020 00:00,1,1,0,29,21,8,13,3,10,20,4
Sat 18 Jan 2020 01:00,1,0,1,21,15,6,1,0,1,18,6
Sat 18 Jan 2020 02:00,1,1,0,12,11,1,0,0,0,5,3
Sat 18 Jan 2020 03:00,1,0,1,14,9,5,2,1,1,14,0
Sat 18 Jan 2020 04:00,0,0,0,6,3,3,3,3,0,7,3
Sat 18 Jan 2020 05:00,2,1,1,11,0,11,6,6,0,4,7
Sat 18 Jan 2020 06:00,0,0,0,44,8,36,21,21,0,10,27
Sat 18 Jan 2020 07:00,1,1,0,46,7,39,44,42,2,14,24
Sat 18 Jan 2020 08:00,2,2,0,68,14,54,22,18,4,12,30
Sat 18 Jan 2020 09:00,7,5,2,72,14,58,27,21,6,14,37
Sat 18 Jan 2020 10:00,2,1,1,70,25,45,28,24,4,16,34
Sat 18 Jan 2020 11:00,3,2,1,71,25,46,28,22,6,23,31
Sat 18 Jan 2020 12:00,2,0,2,102,38,64,33,19,14,45,30
Sat 18 Jan 2020 13:00,7,4,3,80,31,49,51,26,25,38,32
Sat 18 Jan 2020 14:00,5,2,3,103,39,64,45,26,19,50,36
Sat 18 Jan 2020 15:00,0,0,0,77,37,40,36,23,13,56,44
Sat 18 Jan 2020 16:00,6,6,0,94,37,57,38,26,12,44,45
Sat 18 Jan 2020 17:00,5,3,2,109,52,57,25,17,8,47,29
Sat 18 Jan 2020 18:00,1,1,0,83,47,36,40,27,13,38,22
Sat 18 Jan 2020 19:00,2,1,1,61,33,28,22,13,9,40,12
Sat 18 Jan 2020 20:00,4,2,2,46,29,17,17,12,5,28,12
Sat 18 Jan 2020 21:00,4,3,1,30,18,12,15,5,10,25,8
Sat 18 Jan 2020 22:00,4,2,2,39,26,13,13,9,4,19,9
Sat 18 Jan 2020 23:00,5,3,2,31,21,10,11,2,9,22,6
Sun 19 Jan 2020 00:00,0,0,0,22,17,5,17,5,12,11,4
Sun 19 Jan 2020 01:00,0,0,0,22,17,5,4,2,2,16,3
Sun 19 Jan 2020 02:00,1,1,0,12,10,2,1,1,0,4,0
Sun 19 Jan 2020 03:00,0,0,0,8,6,2,2,1,1,6,0
Sun 19 Jan 2020 04:00,0,0,0,5,2,3,1,1,0,3,3
Sun 19 Jan 2020 05:00,0,0,0,7,3,4,5,5,0,4,5
Sun 19 Jan 2020 06:00,2,1,1,32,6,26,8,8,0,9,12
Sun 19 Jan 2020 07:00,0,0,0,23,4,19,16,15,1,8,14
Sun 19 Jan 2020 08:00,2,1,1,39,12,27,16,14,2,7,13
Sun 19 Jan 2020 09:00,1,1,0,64,23,41,27,19,8,12,27
Sun 19 Jan 2020 10:00,0,0,0,57,8,49,29,14,15,35,27
Sun 19 Jan 2020 11:00,1,0,1,62,20,42,25,13,12,20,14
Sun 19 Jan 2020 12:00,3,1,2,91,46,45,44,28,16,51,36
Sun 19 Jan 2020 13:00,3,0,3,69,33,36,43,25,18,33,35
Sun 19 Jan 2020 14:00,3,2,1,88,41,47,30,16,14,31,38
Sun 19 Jan 2020 15:00,6,3,3,79,32,47,33,18,15,27,38
Sun 19 Jan 2020 16:00,3,2,1,78,26,52,37,28,9,25,28
Sun 19 Jan 2020 17:00,5,2,3,80,37,43,27,14,13,37,20
Sun 19 Jan 2020 18:00,4,3,1,105,40,65,35,19,16,37,11
Sun 19 Jan 2020 19:00,3,2,1,57,34,23,17,11,6,32,10
Sun 19 Jan 2020 20:00,1,0,1,56,31,25,19,8,11,25,4
Sun 19 Jan 2020 21:00,2,1,1,28,22,6,19,10,9,12,1
Sun 19 Jan 2020 22:00,3,2,1,35,26,9,14,6,8,11,2
Sun 19 Jan 2020 23:00,0,0,0,25,21,4,6,2,4,16,3
Mon 20 Jan 2020 00:00,1,0,1,14,10,4,2,0,2,12,1
Mon 20 Jan 2020 01:00,0,0,0,4,2,2,2,2,0,6,3
Mon 20 Jan 2020 02:00,0,0,0,3,3,0,1,1,0,1,0
Mon 20 Jan 2020 03:00,0,0,0,4,0,4,2,2,0,3,0
Mon 20 Jan 2020 04:00,0,0,0,8,0,8,6,6,0,3,6
Mon 20 Jan 2020 05:00,1,1,0,36,7,29,26,24,2,7,16
Mon 20 Jan 2020 06:00,5,5,0,151,24,127,136,132,4,12,104
Mon 20 Jan 2020 07:00,11,10,1,385,43,342,180,163,17,40,196
Mon 20 Jan 2020 08:00,36,31,5,867,82,785,335,310,25,48,442
Mon 20 Jan 2020 09:00,24,12,12,421,63,358,185,167,18,35,254
Mon 20 Jan 2020 10:00,5,2,3,83,17,66,41,40,1,12,52
Mon 20 Jan 2020 11:00,3,1,2,59,19,40,29,23,6,25,28
Mon 20 Jan 2020 12:00,5,3,2,91,28,63,35,27,8,39,39
Mon 20 Jan 2020 13:00,5,4,1,129,57,72,43,24,19,58,48
Mon 20 Jan 2020 14:00,5,3,2,107,53,54,46,25,21,71,41
Mon 20 Jan 2020 15:00,6,3,3,125,76,49,41,22,19,59,26
Mon 20 Jan 2020 16:00,12,6,6,238,154,84,78,34,44,195,49
Mon 20 Jan 2020 17:00,6,2,4,583,463,120,179,60,119,452,83
Mon 20 Jan 2020 18:00,13,6,7,496,391,105,153,49,104,360,48
Mon 20 Jan 2020 19:00,4,3,1,209,156,53,81,29,52,134,37
Mon 20 Jan 2020 20:00,6,4,2,132,94,38,37,15,22,77,24
Mon 20 Jan 2020 21:00,2,1,1,69,44,25,25,11,14,58,11
Mon 20 Jan 2020 22:00,0,0,0,41,32,9,12,3,9,42,7
Mon 20 Jan 2020 23:00,1,0,1,25,21,4,12,6,6,15,3
Tue 21 Jan 2020 00:00,1,0,1,10,7,3,6,1,5,8,1
Tue 21 Jan 2020 01:00,1,0,1,2,2,0,1,1,0,6,2
Tue 21 Jan 2020 02:00,0,0,0,8,6,2,2,0,2,6,0
Tue 21 Jan 2020 03:00,0,0,0,5,2,3,1,1,0,5,1
Tue 21 Jan 2020 04:00,0,0,0,7,3,4,5,4,1,4,3
Tue 21 Jan 2020 05:00,1,0,1,37,5,32,21,20,1,5,31
Tue 21 Jan 2020 06:00,9,8,1,156,27,129,135,130,5,8,70
Tue 21 Jan 2020 07:00,15,13,2,479,58,421,187,173,14,40,285
Tue 21 Jan 2020 08:00,50,45,5,1052,100,952,383,360,23,65,327
Tue 21 Jan 2020 09:00,17,16,1,388,48,340,183,167,16,21,251
Tue 21 Jan 2020 10:00,5,1,4,103,25,78,32,29,3,7,54
Tue 21 Jan 2020 11:00,2,0,2,83,32,51,28,21,7,16,43
Tue 21 Jan 2020 12:00,4,3,1,98,38,60,35,26,9,49,45
Tue 21 Jan 2020 13:00,4,4,0,142,64,78,46,29,17,50,41
Tue 21 Jan 2020 14:00,8,3,5,99,37,62,30,22,8,58,24
Tue 21 Jan 2020 15:00,4,2,2,156,83,73,56,28,28,74,27
Tue 21 Jan 2020 16:00,12,7,5,272,187,85,101,44,57,187,43
Tue 21 Jan 2020 17:00,10,2,8,560,439,121,165,55,110,493,75
Tue 21 Jan 2020 18:00,11,4,7,491,382,109,141,48,93,362,54
Tue 21 Jan 2020 19:00,6,5,1,254,180,74,61,20,41,163,16
Tue 21 Jan 2020 20:00,9,3,6,145,104,41,46,17,29,87,9
Tue 21 Jan 2020 21:00,5,3,2,98,68,30,35,10,25,56,15
Tue 21 Jan 2020 22:00,4,2,2,55,37,18,23,9,14,36,9
Tue 21 Jan 2020 23:00,5,1,4,30,24,6,14,5,9,32,3
Wed 22 Jan 2020 00:00,1,1,0,17,12,5,6,2,4,20,3
Wed 22 Jan 2020 01:00,2,0,2,2,2,0,3,0,3,12,1
Wed 22 Jan 2020 02:00,0,0,0,7,6,1,0,0,0,7,1
Wed 22 Jan 2020 03:00,1,0,1,6,1,5,1,1,0,4,0
Wed 22 Jan 2020 04:00,0,0,0,11,2,9,7,6,1,4,7
Wed 22 Jan 2020 05:00,0,0,0,39,6,33,18,17,1,3,26
Wed 22 Jan 2020 06:00,5,5,0,167,18,149,140,139,1,13,86
Wed 22 Jan 2020 07:00,13,11,2,469,77,392,208,190,18,47,238
Wed 22 Jan 2020 08:00,50,44,6,1016,97,919,367,345,22,57,432
Wed 22 Jan 2020 09:00,10,9,1,385,44,341,164,145,19,32,223
Wed 22 Jan 2020 10:00,3,2,1,119,22,97,54,44,10,6,39
Wed 22 Jan 2020 11:00,5,5,0,72,26,46,41,35,6,10,26
Wed 22 Jan 2020 12:00,2,1,1,108,43,65,37,23,14,44,47
Wed 22 Jan 2020 13:00,4,1,3,128,50,78,46,31,15,53,54
Wed 22 Jan 2020 14:00,6,4,2,104,61,43,42,27,15,62,39
Wed 22 Jan 2020 15:00,5,3,2,135,73,62,52,22,30,86,37
Wed 22 Jan 2020 16:00,9,6,3,255,168,87,105,49,56,208,44
Wed 22 Jan 2020 17:00,18,8,10,592,484,108,174,66,108,475,70
Wed 22 Jan 2020 18:00,6,4,2,557,419,138,145,41,104,355,59
Wed 22 Jan 2020 19:00,4,2,2,230,163,67,74,30,44,158,24
Wed 22 Jan 2020 20:00,5,4,1,143,99,44,47,12,35,82,2
Wed 22 Jan 2020 21:00,4,2,2,82,59,23,32,15,17,76,13
Wed 22 Jan 2020 22:00,0,0,0,50,33,17,22,8,14,36,10
Wed 22 Jan 2020 23:00,2,1,1,29,22,7,18,6,12,43,6
Thu 23 Jan 2020 00:00,0,0,0,16,13,3,4,1,3,17,4
Thu 23 Jan 2020 01:00,1,1,0,10,7,3,0,0,0,6,1
Thu 23 Jan 2020 02:00,0,0,0,4,2,2,1,0,1,7,0
Thu 23 Jan 2020 03:00,3,2,1,6,2,4,2,2,0,8,1
Thu 23 Jan 2020 04:00,0,0,0,11,1,10,8,7,1,2,4
Thu 23 Jan 2020 05:00,0,0,0,35,6,29,28,25,3,5,31
Thu 23 Jan 2020 06:00,5,4,1,148,20,128,152,150,2,12,108
Thu 23 Jan 2020 07:00,12,11,1,451,58,393,190,176,14,47,231
Thu 23 Jan 2020 08:00,43,38,5,994,87,907,366,340,26,61,348
Thu 23 Jan 2020 09:00,19,16,3,373,51,322,191,171,20,34,232
Thu 23 Jan 2020 10:00,4,2,2,115,23,92,43,36,7,21,56
Thu 23 Jan 2020 11:00,6,6,0,81,28,53,33,23,10,20,38
Thu 23 Jan 2020 12:00,4,3,1,85,31,54,52,37,15,47,48
Thu 23 Jan 2020 13:00,7,3,4,141,66,75,58,38,20,53,48
Thu 23 Jan 2020 14:00,3,2,1,109,56,53,39,20,19,56,29
Thu 23 Jan 2020 15:00,5,4,1,150,79,71,48,23,25,72,44
Thu 23 Jan 2020 16:00,14,9,5,266,165,101,109,54,55,198,57
Thu 23 Jan 2020 17:00,13,6,7,559,439,120,162,64,98,401,79
Thu 23 Jan 2020 18:00,12,5,7,509,394,115,134,46,88,340,45
Thu 23 Jan 2020 19:00,3,2,1,208,136,72,63,28,35,114,18
Thu 23 Jan 2020 20:00,2,1,1,152,105,47,47,17,30,98,22
Thu 23 Jan 2020 21:00,4,2,2,91,76,15,31,16,15,81,20
Thu 23 Jan 2020 22:00,1,0,1,76,52,24,30,8,22,52,16
Thu 23 Jan 2020 23:00,1,1,0,44,35,9,14,2,12,30,12
Fri 24 Jan 2020 00:00,0,0,0,26,19,7,7,0,7,17,4
Fri 24 Jan 2020 01:00,0,0,0,10,8,2,4,4,0,4,2
Fri 24 Jan 2020 02:00,0,0,0,5,2,3,2,2,0,4,2
Fri 24 Jan 2020 03:00,3,1,2,6,2,4,1,0,1,5,1
Fri 24 Jan 2020 04:00,1,0,1,9,3,6,6,6,0,3,5
Fri 24 Jan 2020 05:00,1,1,0,32,6,26,26,25,1,6,30
Fri 24 Jan 2020 06:00,7,6,1,140,14,126,149,146,3,14,88
Fri 24 Jan 2020 07:00,10,9,1,365,51,314,157,143,14,38,183
Fri 24 Jan 2020 08:00,34,33,1,803,71,732,283,262,21,69,398
Fri 24 Jan 2020 09:00,13,11,2,339,43,296,156,138,18,31,178
Fri 24 Jan 2020 10:00,2,2,0,100,21,79,44,38,6,17,79
Fri 24 Jan 2020 11:00,2,2,0,80,28,52,46,35,11,25,42
Fri 24 Jan 2020 12:00,5,3,2,104,37,67,50,38,12,52,45
Fri 24 Jan 2020 13:00,3,2,1,141,66,75,50,28,22,74,53
Fri 24 Jan 2020 14:00,7,5,2,128,75,53,60,35,25,63,36
Fri 24 Jan 2020 15:00,3,2,1,165,105,60,48,25,23,77,44
Fri 24 Jan 2020 16:00,9,7,2,285,193,92,86,35,51,181,50
Fri 24 Jan 2020 17:00,12,5,7,488,369,119,159,59,100,357,42
Fri 24 Jan 2020 18:00,9,4,5,335,235,100,103,38,65,215,49
Fri 24 Jan 2020 19:00,3,1,2,167,107,60,59,26,33,117,21
Fri 24 Jan 2020 20:00,4,2,2,113,63,50,32,16,16,68,23
Fri 24 Jan 2020 21:00,4,3,1,78,46,32,38,14,24,51,17
Fri 24 Jan 2020 22:00,3,2,1,55,37,18,19,8,11,35,16
Fri 24 Jan 2020 23:00,1,0,1,39,30,9,18,3,15,40,6
Sat 25 Jan 2020 00:00,2,2,0,26,19,7,10,2,8,18,5
Sat 25 Jan 2020 01:00,0,0,0,25,18,7,6,1,5,13,5
Sat 25 Jan 2020 02:00,0,0,0,18,13,5,3,2,1,8,2
Sat 25 Jan 2020 03:00,1,0,1,5,2,3,2,1,1,6,1
Sat 25 Jan 2020 04:00,0,0,0,10,5,5,2,2,0,8,10
Sat 25 Jan 2020 05:00,1,1,0,21,8,13,7,7,0,5,7
Sat 25 Jan 2020 06:00,0,0,0,41,7,34,26,25,1,6,17
Sat 25 Jan 2020 07:00,1,1,0,58,19,39,50,47,3,16,33
Sat 25 Jan 2020 08:00,1,1,0,78,20,58,38,33,5,17,36
Sat 25 Jan 2020 09:00,1,1,0,92,22,70,31,26,5,14,43
Sat 25 Jan 2020 10:00,0,0,0,80,27,53,41,28,13,34,46
Sat 25 Jan 2020 11:00,5,3,2,100,37,63,39,29,10,32,31
Sat 25 Jan 2020 12:00,3,1,2,93,40,53,41,31,10,49,35
Sat 25 Jan 2020 13:00,10,5,5,95,38,57,61,41,20,47,51
Sat 25 Jan 2020 14:00,4,3,1,103,43,60,43,21,22,51,53
Sat 25 Jan 2020 15:00,6,3,3,97,45,52,48,25,23,44,43
Sat 25 Jan 2020 16:00,2,2,0,92,43,49,44,31,13,53,31
Sat 25 Jan 2020 17:00,3,3,0,106,49,57,30,19,11,40,23
Sat 25 Jan 2020 18:00,4,2,2,96,44,52,37,20,17,45,17
Sat 25 Jan 2020 19:00,3,1,2,75,37,38,31,19,12,41,12
Sat 25 Jan 2020 20:00,1,1,0,59,27,32,22,15,7,35,12
Sat 25 Jan 2020 21:00,5,3,2,49,26,23,23,16,7,24,17
Sat 25 Jan 2020 22:00,1,1,0,46,34,12,12,4,8,18,12
Sat 25 Jan 2020 23:00,0,0,0,29,18,11,13,4,9,26,7
Sun 26 Jan 2020 00:00,1,1,0,24,16,8,11,5,6,13,6
Sun 26 Jan 2020 01:00,2,1,1,14,10,4,9,4,5,17,5
Sun 26 Jan 2020 02:00,0,0,0,11,6,5,2,1,1,9,2
Sun 26 Jan 2020 03:00,0,0,0,5,4,1,2,0,2,7,0
Sun 26 Jan 2020 04:00,2,0,2,12,8,4,1,1,0,6,4
Sun 26 Jan 2020 05:00,0,0,0,8,3,5,7,7,0,6,5
Sun 26 Jan 2020 06:00,1,1,0,29,5,24,14,14,0,11,13
Sun 26 Jan 2020 07:00,3,0,3,26,7,19,15,12,3,5,19
Sun 26 Jan 2020 08:00,0,0,0,42,12,30,18,18,0,10,18
Sun 26 Jan 2020 09:00,2,2,0,66,20,46,17,15,2,14,20
Sun 26 Jan 2020 10:00,6,4,2,89,17,72,49,43,6,17,39
Sun 26 Jan 2020 11:00,9,6,3,67,26,41,54,43,11,21,36
Sun 26 Jan 2020 12:00,3,1,2,90,39,51,44,22,22,39,38
Sun 26 Jan 2020 13:00,4,2,2,80,34,46,60,36,24,38,27
Sun 26 Jan 2020 14:00,3,2,1,73,35,38,25,16,9,30,12
Sun 26 Jan 2020 15:00,4,2,2,93,44,49,25,14,11,25,28
Sun 26 Jan 2020 16:00,1,0,1,95,32,63,30,19,11,33,38
Sun 26 Jan 2020 17:00,1,1,0,87,40,47,32,21,11,55,26
Sun 26 Jan 2020 18:00,0,0,0,71,32,39,37,17,20,27,15
Sun 26 Jan 2020 19:00,1,1,0,61,33,28,27,19,8,23,10
Sun 26 Jan 2020 20:00,3,2,1,64,37,27,19,9,10,29,4
Sun 26 Jan 2020 21:00,3,2,1,38,26,12,12,7,5,16,4
Sun 26 Jan 2020 22:00,3,3,0,36,26,10,11,2,9,27,6
Sun 26 Jan 2020 23:00,1,1,0,20,17,3,5,2,3,15,6
Mon 27 Jan 2020 00:00,2,0,2,8,6,2,2,1,1,3,0
Mon 27 Jan 2020 01:00,0,0,0,6,5,1,0,0,0,11,3
Mon 27 Jan 2020 02:00,0,0,0,9,6,3,2,0,2,4,0
Mon 27 Jan 2020 03:00,0,0,0,7,2,5,1,1,0,4,1
Mon 27 Jan 2020 04:00,3,2,1,9,3,6,8,7,1,6,4
Mon 27 Jan 2020 05:00,1,1,0,28,3,25,27,26,1,2,19
Mon 27 Jan 2020 06:00,5,5,0,150,12,138,130,126,4,11,103
Mon 27 Jan 2020 07:00,15,10,5,364,45,319,178,164,14,40,237
Mon 27 Jan 2020 08:00,40,37,3,925,85,840,352,327,25,57,434
Mon 27 Jan 2020 09:00,13,12,1,381,41,340,176,157,19,28,287
Mon 27 Jan 2020 10:00,4,2,2,102,19,83,28,27,1,12,55
Mon 27 Jan 2020 11:00,2,2,0,75,24,51,31,21,10,16,34
Mon 27 Jan 2020 12:00,0,0,0,113,39,74,42,27,15,37,41
Mon 27 Jan 2020 13:00,9,7,2,101,43,58,39,21,18,50,33
Mon 27 Jan 2020 14:00,8,5,3,89,43,46,44,29,15,64,33
Mon 27 Jan 2020 15:00,5,3,2,131,75,56,37,16,21,68,38
Mon 27 Jan 2020 16:00,9,5,4,230,153,77,83,45,38,187,45
Mon 27 Jan 2020 17:00,23,9,14,530,425,105,192,64,128,456,62
Mon 27 Jan 2020 18:00,7,1,6,459,364,95,139,39,100,355,49
Mon 27 Jan 2020 19:00,1,1,0,213,160,53,78,34,44,156,17
Mon 27 Jan 2020 20:00,4,3,1,140,110,30,28,16,12,83,5
Mon 27 Jan 2020 21:00,4,1,3,94,77,17,38,15,23,61,7
Mon 27 Jan 2020 22:00,1,1,0,52,38,14,16,5,11,46,7
Mon 27 Jan 2020 23:00,2,0,2,27,26,1,7,4,3,20,3
Tue 28 Jan 2020 00:00,0,0,0,9,8,1,5,2,3,10,4
Tue 28 Jan 2020 01:00,0,0,0,6,4,2,1,1,0,6,0
Tue 28 Jan 2020 02:00,0,0,0,5,3,2,2,1,1,5,2
Tue 28 Jan 2020 03:00,0,0,0,3,0,3,0,0,0,2,0
Tue 28 Jan 2020 04:00,1,0,1,9,3,6,8,8,0,5,5
Tue 28 Jan 2020 05:00,1,1,0,34,7,27,18,15,3,1,22
Tue 28 Jan 2020 06:00,6,6,0,171,24,147,137,135,2,13,99
Tue 28 Jan 2020 07:00,12,9,3,433,60,373,195,177,18,32,154
Tue 28 Jan 2020 08:00,50,44,6,1042,90,952,344,325,19,64,377
Tue 28 Jan 2020 09:00,13,11,2,367,44,323,187,168,19,20,267
Tue 28 Jan 2020 10:00,3,2,1,88,18,70,27,23,4,17,63
Tue 28 Jan 2020 11:00,7,4,3,80,26,54,29,21,8,18,31
Tue 28 Jan 2020 12:00,4,4,0,97,34,63,35,26,9,40,36
Tue 28 Jan 2020 13:00,4,3,1,123,55,68,33,20,13,56,38
Tue 28 Jan 2020 14:00,3,2,1,89,43,46,41,28,13,55,28
Tue 28 Jan 2020 15:00,3,2,1,123,84,39,55,26,29,68,31
Tue 28 Jan 2020 16:00,9,7,2,234,161,73,94,40,54,196,39
Tue 28 Jan 2020 17:00,14,3,11,534,436,98,181,62,119,419,65
Tue 28 Jan 2020 18:00,14,5,9,513,407,106,140,37,103,324,27
Tue 28 Jan 2020 19:00,6,4,2,250,174,76,84,30,54,159,13
Tue 28 Jan 2020 20:00,2,1,1,144,95,49,46,16,30,78,14
Tue 28 Jan 2020 21:00,2,1,1,90,70,20,32,19,13,48,6
Tue 28 Jan 2020 22:00,1,1,0,69,50,19,28,11,17,36,7
Tue 28 Jan 2020 23:00,1,0,1,34,26,8,17,2,15,28,6
Wed 29 Jan 2020 00:00,3,1,2,25,19,6,2,1,1,12,3
Wed 29 Jan 2020 01:00,0,0,0,6,5,1,1,1,0,6,2
Wed 29 Jan 2020 02:00,0,0,0,5,3,2,2,1,1,3,1
Wed 29 Jan 2020 03:00,0,0,0,5,1,4,1,1,0,6,0
Wed 29 Jan 2020 04:00,0,0,0,9,3,6,4,4,0,10,5
Wed 29 Jan 2020 05:00,1,1,0,36,6,30,27,25,2,2,18
Wed 29 Jan 2020 06:00,4,2,2,164,19,145,134,131,3,11,69
Wed 29 Jan 2020 07:00,13,11,2,412,51,361,187,165,22,39,197
Wed 29 Jan 2020 08:00,40,35,5,919,78,841,376,351,25,62,410
Wed 29 Jan 2020 09:00,22,18,4,375,42,333,174,150,24,20,188
Wed 29 Jan 2020 10:00,3,2,1,118,23,95,40,36,4,14,46
Wed 29 Jan 2020 11:00,2,1,1,78,25,53,32,30,2,9,15
Wed 29 Jan 2020 12:00,3,3,0,92,32,60,40,31,9,42,28
Wed 29 Jan 2020 13:00,6,4,2,118,47,71,48,27,21,42,53
Wed 29 Jan 2020 14:00,1,1,0,100,51,49,50,33,17,42,29
Wed 29 Jan 2020 15:00,5,4,1,137,67,70,37,13,24,88,35
Wed 29 Jan 2020 16:00,9,4,5,273,179,94,92,45,47,182,52
Wed 29 Jan 2020 17:00,15,5,10,554,432,122,177,56,121,445,79
Wed 29 Jan 2020 18:00,5,1,4,479,378,101,143,47,96,352,35
Wed 29 Jan 2020 19:00,4,1,3,245,187,58,68,22,46,139,17
Wed 29 Jan 2020 20:00,5,1,4,142,88,54,49,13,36,89,9
Wed 29 Jan 2020 21:00,1,1,0,75,46,29,29,12,17,66,2
Wed 29 Jan 2020 22:00,0,0,0,68,50,18,25,7,18,48,5
Wed 29 Jan 2020 23:00,1,0,1,31,25,6,14,2,12,28,7
Thu 30 Jan 2020 00:00,1,1,0,26,19,7,3,1,2,15,5
Thu 30 Jan 2020 01:00,0,0,0,7,5,2,0,0,0,10,0
Thu 30 Jan 2020 02:00,1,0,1,6,3,3,0,0,0,6,0
Thu 30 Jan 2020 03:00,0,0,0,6,2,4,1,1,0,1,0
Thu 30 Jan 2020 04:00,0,0,0,10,2,8,6,6,0,1,4
Thu 30 Jan 2020 05:00,2,1,1,38,5,33,26,25,1,4,13
Thu 30 Jan 2020 06:00,8,6,2,155,22,133,142,138,4,21,104
Thu 30 Jan 2020 07:00,10,9,1,429,47,382,193,184,9,30,161
Thu 30 Jan 2020 08:00,41,38,3,928,97,831,325,305,20,52,364
Thu 30 Jan 2020 09:00,11,10,1,431,66,365,171,159,12,22,242
Thu 30 Jan 2020 10:00,2,1,1,132,36,96,40,35,5,22,63
Thu 30 Jan 2020 11:00,11,7,4,82,28,54,42,26,16,26,43
Thu 30 Jan 2020 12:00,6,3,3,110,41,69,44,35,9,42,56
Thu 30 Jan 2020 13:00,9,5,4,107,40,67,61,41,20,53,40
Thu 30 Jan 2020 14:00,9,3,6,112,66,46,32,19,13,70,34
Thu 30 Jan 2020 15:00,8,5,3,139,81,58,46,22,24,71,36
Thu 30 Jan 2020 16:00,9,3,6,258,172,86,82,40,42,180,53
Thu 30 Jan 2020 17:00,20,5,15,518,394,124,174,64,110,343,62
Thu 30 Jan 2020 18:00,9,4,5,412,324,88,135,42,93,313,50
Thu 30 Jan 2020 19:00,6,1,5,196,143,53,66,23,43,142,27
Thu 30 Jan 2020 20:00,4,1,3,180,125,55,48,20,28,99,20
Thu 30 Jan 2020 21:00,2,1,1,103,86,17,30,8,22,83,16
Thu 30 Jan 2020 22:00,3,2,1,73,52,21,22,6,16,51,9
Thu 30 Jan 2020 23:00,1,0,1,41,29,12,13,2,11,38,6
Fri 31 Jan 2020 00:00,2,2,0,23,16,7,3,0,3,23,2
Fri 31 Jan 2020 01:00,0,0,0,14,13,1,3,2,1,6,0
Fri 31 Jan 2020 02:00,0,0,0,4,2,2,3,2,1,10,1
Fri 31 Jan 2020 03:00,0,0,0,8,4,4,2,2,0,1,1
Fri 31 Jan 2020 04:00,0,0,0,14,6,8,5,5,0,7,4
Fri 31 Jan 2020 05:00,3,1,2,34,5,29,27,24,3,3,17
Fri 31 Jan 2020 06:00,3,2,1,132,14,118,141,132,9,13,84
Fri 31 Jan 2020 07:00,9,8,1,326,39,287,159,146,13,25,195
Fri 31 Jan 2020 08:00,36,33,3,803,90,713,290,275,15,40,329
Fri 31 Jan 2020 09:00,15,10,5,372,63,309,175,158,17,22,210
Fri 31 Jan 2020 10:00,2,1,1,113,26,87,33,30,3,17,74
Fri 31 Jan 2020 11:00,3,2,1,85,27,58,30,26,4,22,37
Fri 31 Jan 2020 12:00,9,6,3,89,26,63,48,30,18,52,42
Fri 31 Jan 2020 13:00,4,1,3,151,71,80,46,28,18,58,49
Fri 31 Jan 2020 14:00,6,3,3,132,68,64,43,20,23,73,29
Fri 31 Jan 2020 15:00,5,2,3,130,79,51,43,24,19,88,31
Fri 31 Jan 2020 16:00,6,3,3,246,152,94,84,31,53,162,50
Fri 31 Jan 2020 17:00,11,3,8,462,348,114,145,52,93,328,61
Fri 31 Jan 2020 18:00,9,3,6,353,250,103,90,28,62,228,25
Fri 31 Jan 2020 19:00,4,3,1,171,118,53,55,21,34,116,29
Fri 31 Jan 2020 20:00,3,2,1,102,68,34,48,19,29,92,26
Fri 31 Jan 2020 21:00,4,4,0,89,54,35,35,12,23,46,19
Fri 31 Jan 2020 22:00,6,6,0,56,35,21,38,13,25,41,18
Fri 31 Jan 2020 23:00,2,2,0,56,40,16,22,5,17,35,4
Sat 1 Feb 2020 00:00,1,1,0,40,27,13,8,3,5,14,8
Sat 1 Feb 2020 01:00,1,1,0,17,12,5,5,3,2,6,1
Sat 1 Feb 2020 02:00,3,1,2,10,8,2,7,4,3,22,2
Sat 1 Feb 2020 03:00,0,0,0,10,7,3,1,0,1,1,3
Sat 1 Feb 2020 04:00,4,2,2,11,8,3,3,2,1,5,2
Sat 1 Feb 2020 05:00,1,0,1,19,5,14,6,6,0,4,7
Sat 1 Feb 2020 06:00,1,1,0,40,10,30,18,17,1,8,10
Sat 1 Feb 2020 07:00,1,1,0,46,12,34,28,26,2,10,29
Sat 1 Feb 2020 08:00,2,2,0,71,14,57,30,28,2,9,24
Sat 1 Feb 2020 09:00,2,2,0,94,22,72,33,23,10,23,30
Sat 1 Feb 2020 10:00,2,1,1,78,33,45,31,29,2,16,29
Sat 1 Feb 2020 11:00,3,1,2,97,25,72,48,38,10,24,32
Sat 1 Feb 2020 12:00,6,2,4,101,41,60,44,22,22,31,31
Sat 1 Feb 2020 13:00,4,3,1,96,38,58,50,35,15,40,54
Sat 1 Feb 2020 14:00,4,3,1,98,39,59,37,31,6,35,25
Sat 1 Feb 2020 15:00,3,1,2,105,40,65,43,29,14,35,26
Sat 1 Feb 2020 16:00,8,3,5,86,31,55,32,26,6,48,32
Sat 1 Feb 2020 17:00,3,3,0,105,51,54,29,17,12,48,38
Sat 1 Feb 2020 18:00,4,3,1,75,38,37,30,16,14,40,23
Sat 1 Feb 2020 19:00,3,2,1,95,45,50,23,16,7,38,16
Sat 1 Feb 2020 20:00,4,4,0,89,48,41,26,12,14,29,8
Sat 1 Feb 2020 21:00,6,2,4,49,32,17,21,8,13,26,11
Sat 1 Feb 2020 22:00,1,0,1,46,33,13,16,8,8,28,6
Sat 1 Feb 2020 23:00,3,3,0,40,31,9,14,4,10,27,9
Sun 2 Feb 2020 00:00,1,1,0,28,19,9,13,3,10,17,7
Sun 2 Feb 2020 01:00,1,0,1,16,8,8,8,1,7,10,0
Sun 2 Feb 2020 02:00,0,0,0,15,13,2,2,0,2,11,1
Sun 2 Feb 2020 03:00,0,0,0,9,8,1,1,0,1,5,0
Sun 2 Feb 2020 04:00,1,0,1,7,2,5,3,3,0,3,2
Sun 2 Feb 2020 05:00,0,0,0,13,4,9,6,6,0,3,8
Sun 2 Feb 2020 06:00,1,0,1,28,4,24,10,9,1,10,13
Sun 2 Feb 2020 07:00,2,1,1,39,7,32,21,20,1,14,14
Sun 2 Feb 2020 08:00,2,1,1,40,13,27,12,11,1,7,18
Sun 2 Feb 2020 09:00,2,2,0,71,20,51,19,17,2,8,24
Sun 2 Feb 2020 10:00,1,0,1,69,13,56,26,19,7,11,15
Sun 2 Feb 2020 11:00,6,3,3,75,23,52,25,21,4,18,27
Sun 2 Feb 2020 12:00,5,2,3,105,32,73,32,24,8,39,20
Sun 2 Feb 2020 13:00,5,4,1,111,44,67,50,32,18,39,30
Sun 2 Feb 2020 14:00,3,3,0,69,31,38,38,22,16,31,21
Sun 2 Feb 2020 15:00,3,1,2,92,47,45,33,17,16,34,31
Sun 2 Feb 2020 16:00,2,2,0,86,33,53,27,18,9,27,28
Sun 2 Feb 2020 17:00,5,2,3,81,37,44,26,15,11,29,28
Sun 2 Feb 2020 18:00,3,3,0,86,54,32,39,21,18,32,29
Sun 2 Feb 2020 19:00,1,0,1,61,41,20,29,16,13,34,13
Sun 2 Feb 2020 20:00,1,0,1,39,23,16,22,8,14,23,13
Sun 2 Feb 2020 21:00,2,1,1,31,23,8,19,10,9,18,6
Sun 2 Feb 2020 22:00,1,0,1,24,13,11,11,2,9,15,6
Sun 2 Feb 2020 23:00,0,0,0,19,13,6,9,2,7,16,4
Mon 3 Feb 2020 00:00,1,1,0,15,13,2,3,1,2,10,0
Mon 3 Feb 2020 01:00,0,0,0,6,4,2,1,0,1,5,4
Mon 3 Feb 2020 02:00,0,0,0,5,3,2,0,0,0,2,0
Mon 3 Feb 2020 03:00,0,0,0,5,0,5,4,4,0,4,0
Mon 3 Feb 2020 04:00,0,0,0,5,2,3,5,5,0,5,8
Mon 3 Feb 2020 05:00,1,1,0,32,3,29,24,21,3,3,21
Mon 3 Feb 2020 06:00,9,7,2,133,23,110,135,131,4,16,100
Mon 3 Feb 2020 07:00,11,8,3,400,58,342,167,156,11,30,213
Mon 3 Feb 2020 08:00,41,36,5,938,101,837,348,320,28,55,351
Mon 3 Feb 2020 09:00,15,14,1,356,43,313,155,141,14,33,236
Mon 3 Feb 2020 10:00,3,3,0,80,11,69,44,41,3,7,42
Mon 3 Feb 2020 11:00,4,3,1,69,21,48,23,18,5,21,25
Mon 3 Feb 2020 12:00,4,2,2,86,31,55,38,22,16,36,25
Mon 3 Feb 2020 13:00,2,1,1,99,41,58,43,23,20,64,46
Mon 3 Feb 2020 14:00,5,3,2,87,44,43,32,21,11,45,31
Mon 3 Feb 2020 15:00,4,1,3,123,69,54,36,20,16,55,40
Mon 3 Feb 2020 16:00,10,4,6,219,149,70,89,40,49,173,53
Mon 3 Feb 2020 17:00,13,2,11,563,456,107,187,51,136,413,40
Mon 3 Feb 2020 18:00,11,5,6,509,402,107,147,39,108,329,27
Mon 3 Feb 2020 19:00,3,2,1,222,163,59,55,17,38,135,14
Mon 3 Feb 2020 20:00,3,2,1,121,92,29,36,19,17,68,6
Mon 3 Feb 2020 21:00,3,3,0,87,63,24,41,16,25,73,9
Mon 3 Feb 2020 22:00,1,0,1,41,34,7,12,5,7,28,2
Mon 3 Feb 2020 23:00,0,0,0,26,22,4,6,1,5,17,3
Tue 4 Feb 2020 00:00,0,0,0,10,8,2,4,2,2,9,2
Tue 4 Feb 2020 01:00,0,0,0,4,3,1,2,2,0,6,0
Tue 4 Feb 2020 02:00,1,0,1,6,4,2,0,0,0,4,1
Tue 4 Feb 2020 03:00,1,0,1,6,4,2,2,2,0,5,0
Tue 4 Feb 2020 04:00,0,0,0,6,3,3,5,4,1,5,4
Tue 4 Feb 2020 05:00,0,0,0,34,4,30,23,22,1,3,20
Tue 4 Feb 2020 06:00,5,5,0,144,18,126,135,132,3,12,102
Tue 4 Feb 2020 07:00,15,11,4,447,57,390,214,195,19,34,222
Tue 4 Feb 2020 08:00,38,32,6,1068,101,967,329,306,23,68,464
Tue 4 Feb 2020 09:00,15,14,1,410,50,360,169,152,17,20,222
Tue 4 Feb 2020 10:00,5,3,2,102,24,78,42,36,6,25,58
Tue 4 Feb 2020 11:00,8,7,1,80,31,49,33,24,9,27,35
Tue 4 Feb 2020 12:00,6,5,1,101,28,73,43,23,20,60,55
Tue 4 Feb 2020 13:00,8,7,1,104,48,56,43,26,17,53,43
Tue 4 Feb 2020 14:00,5,1,4,110,57,53,38,20,18,58,39
Tue 4 Feb 2020 15:00,5,1,4,129,73,56,46,23,23,65,30
Tue 4 Feb 2020 16:00,9,4,5,247,168,79,81,37,44,186,60
Tue 4 Feb 2020 17:00,19,7,12,586,458,128,188,65,123,398,76
Tue 4 Feb 2020 18:00,8,3,5,533,415,118,150,52,98,375,37
Tue 4 Feb 2020 19:00,8,3,5,237,171,66,75,34,41,185,7
Tue 4 Feb 2020 20:00,4,2,2,133,112,21,43,21,22,84,8
Tue 4 Feb 2020 21:00,9,7,2,95,62,33,43,17,26,71,13
Tue 4 Feb 2020 22:00,2,1,1,57,39,18,21,5,16,44,6
Tue 4 Feb 2020 23:00,1,0,1,26,21,5,13,4,9,33,4
Wed 5 Feb 2020 00:00,1,1,0,20,15,5,6,1,5,9,2
Wed 5 Feb 2020 01:00,2,0,2,4,2,2,3,1,2,8,0
Wed 5 Feb 2020 02:00,0,0,0,7,6,1,1,0,1,6,1
Wed 5 Feb 2020 03:00,1,0,1,5,4,1,4,4,0,5,0
Wed 5 Feb 2020 04:00,0,0,0,7,1,6,6,5,1,2,6
Wed 5 Feb 2020 05:00,1,1,0,35,10,25,24,21,3,3,25
Wed 5 Feb 2020 06:00,8,7,1,138,18,120,142,139,3,16,98
Wed 5 Feb 2020 07:00,8,8,0,436,60,376,193,178,15,32,214
Wed 5 Feb 2020 08:00,43,38,5,1014,88,926,370,347,23,44,422
Wed 5 Feb 2020 09:00,17,13,4,414,51,363,180,159,21,39,236
Wed 5 Feb 2020 10:00,5,3,2,105,18,87,35,31,4,18,79
Wed 5 Feb 2020 11:00,3,2,1,71,28,43,30,25,5,18,40
Wed 5 Feb 2020 12:00,3,3,0,92,36,56,43,27,16,46,51
Wed 5 Feb 2020 13:00,5,4,1,128,51,77,45,25,20,57,50
Wed 5 Feb 2020 14:00,8,4,4,98,41,57,46,26,20,17,26
Wed 5 Feb 2020 15:00,5,5,0,130,66,64,42,19,23,93,35
Wed 5 Feb 2020 16:00,13,7,6,241,154,87,98,51,47,198,44
Wed 5 Feb 2020 17:00,20,11,9,551,444,107,165,59,106,444,101
Wed 5 Feb 2020 18:00,14,7,7,472,358,114,147,43,104,387,51
Wed 5 Feb 2020 19:00,6,3,3,210,158,52,70,26,44,140,27
Wed 5 Feb 2020 20:00,10,6,4,139,98,41,53,23,30,86,7
Wed 5 Feb 2020 21:00,5,5,0,109,76,33,41,19,22,74,10
Wed 5 Feb 2020 22:00,1,1,0,77,55,22,23,9,14,42,3
Wed 5 Feb 2020 23:00,1,0,1,46,32,14,11,1,10,31,5
Thu 6 Feb 2020 00:00,0,0,0,16,11,5,5,0,5,19,4
Thu 6 Feb 2020 01:00,1,0,1,12,11,1,1,1,0,7,0
Thu 6 Feb 2020 02:00,1,1,0,3,2,1,1,1,0,7,0
Thu 6 Feb 2020 03:00,0,0,0,9,3,6,2,2,0,3,1
Thu 6 Feb 2020 04:00,0,0,0,6,2,4,7,7,0,5,5
Thu 6 Feb 2020 05:00,0,0,0,35,4,31,29,27,2,4,21
Thu 6 Feb 2020 06:00,10,9,1,139,22,117,150,146,4,14,88
Thu 6 Feb 2020 07:00,6,4,2,428,56,372,186,174,12,31,222
Thu 6 Feb 2020 08:00,43,36,7,952,92,860,335,307,28,58,374
Thu 6 Feb 2020 09:00,17,15,2,405,48,357,166,145,21,18,203
Thu 6 Feb 2020 10:00,2,1,1,91,17,74,43,38,5,9,39
Thu 6 Feb 2020 11:00,5,3,2,69,18,51,38,32,6,11,33
Thu 6 Feb 2020 12:00,5,3,2,107,45,62,43,27,16,43,48
Thu 6 Feb 2020 13:00,4,3,1,113,52,61,55,31,24,49,58
Thu 6 Feb 2020 14:00,6,3,3,100,49,51,37,29,8,71,46
Thu 6 Feb 2020 15:00,6,4,2,136,74,62,43,15,28,70,40
Thu 6 Feb 2020 16:00,8,4,4,259,164,95,103,53,50,184,63
Thu 6 Feb 2020 17:00,17,5,12,581,453,128,178,62,116,356,85
Thu 6 Feb 2020 18:00,10,4,6,441,339,102,104,36,68,316,45
Thu 6 Feb 2020 19:00,3,1,2,223,169,54,68,24,44,110,13
Thu 6 Feb 2020 20:00,8,1,7,188,137,51,27,14,13,83,12
Thu 6 Feb 2020 21:00,5,3,2,113,77,36,41,15,26,69,0
Thu 6 Feb 2020 22:00,0,0,0,80,54,26,29,9,20,55,8
Thu 6 Feb 2020 23:00,1,1,0,44,34,10,21,5,16,26,9
Fri 7 Feb 2020 00:00,1,0,1,23,16,7,7,3,4,22,3
Fri 7 Feb 2020 01:00,0,0,0,8,7,1,2,0,2,9,1
Fri 7 Feb 2020 02:00,1,0,1,12,8,4,1,1,0,7,1
Fri 7 Feb 2020 03:00,1,1,0,4,1,3,6,4,2,8,1
Fri 7 Feb 2020 04:00,1,0,1,10,4,6,4,4,0,4,5
Fri 7 Feb 2020 05:00,1,1,0,28,3,25,20,19,1,4,22
Fri 7 Feb 2020 06:00,6,6,0,136,13,123,140,136,4,20,83
Fri 7 Feb 2020 07:00,6,6,0,356,39,317,168,156,12,28,166
Fri 7 Feb 2020 08:00,25,22,3,755,65,690,283,258,25,47,413
Fri 7 Feb 2020 09:00,17,15,2,354,43,311,142,134,8,24,168
Fri 7 Feb 2020 10:00,2,1,1,82,17,65,33,24,9,10,45
Fri 7 Feb 2020 11:00,3,2,1,80,27,53,36,30,6,14,36
Fri 7 Feb 2020 12:00,4,1,3,117,44,73,51,31,20,47,59
Fri 7 Feb 2020 13:00,1,0,1,151,74,77,44,26,18,68,34
Fri 7 Feb 2020 14:00,4,1,3,134,75,59,42,20,22,71,26
Fri 7 Feb 2020 15:00,7,6,1,154,78,76,40,23,17,70,19
Fri 7 Feb 2020 16:00,8,6,2,230,162,68,88,30,58,127,27
Fri 7 Feb 2020 17:00,10,3,7,465,370,95,133,46,87,289,38
Fri 7 Feb 2020 18:00,8,4,4,323,235,88,99,35,64,171,26
Fri 7 Feb 2020 19:00,3,0,3,158,115,43,61,32,29,96,26
Fri 7 Feb 2020 20:00,8,4,4,97,65,32,40,24,16,70,15
Fri 7 Feb 2020 21:00,3,1,2,88,60,28,21,10,11,45,20
Fri 7 Feb 2020 22:00,3,3,0,44,32,12,20,8,12,28,15
Fri 7 Feb 2020 23:00,5,2,3,57,37,20,5,2,3,19,7
Sat 8 Feb 2020 00:00,1,1,0,28,20,8,15,4,11,15,6
Sat 8 Feb 2020 01:00,1,1,0,11,7,4,4,1,3,20,1
Sat 8 Feb 2020 02:00,3,2,1,14,12,2,0,0,0,10,1
Sat 8 Feb 2020 03:00,0,0,0,10,8,2,2,1,1,8,1
Sat 8 Feb 2020 04:00,2,0,2,3,1,2,1,1,0,5,6
Sat 8 Feb 2020 05:00,1,1,0,19,4,15,5,5,0,1,7
Sat 8 Feb 2020 06:00,0,0,0,49,9,40,23,23,0,4,19
Sat 8 Feb 2020 07:00,1,1,0,57,17,40,44,41,3,5,23
Sat 8 Feb 2020 08:00,3,3,0,65,15,50,34,31,3,6,45
Sat 8 Feb 2020 09:00,1,1,0,86,17,69,40,39,1,24,35
Sat 8 Feb 2020 10:00,1,0,1,77,23,54,36,28,8,22,32
Sat 8 Feb 2020 11:00,6,3,3,71,22,49,53,39,14,16,29
Sat 8 Feb 2020 12:00,4,0,4,94,40,54,35,23,12,42,37
Sat 8 Feb 2020 13:00,6,4,2,85,41,44,51,27,24,42,23
Sat 8 Feb 2020 14:00,12,6,6,79,44,35,38,19,19,48,27
Sat 8 Feb 2020 15:00,2,1,1,56,29,27,28,13,15,32,25
Sat 8 Feb 2020 16:00,4,3,1,67,22,45,33,21,12,30,10
Sat 8 Feb 2020 17:00,2,1,1,104,38,66,21,12,9,27,10
Sat 8 Feb 2020 18:00,7,4,3,78,38,40,19,7,12,37,9
Sat 8 Feb 2020 19:00,4,3,1,37,22,15,16,10,6,30,8
Sat 8 Feb 2020 20:00,1,0,1,26,13,13,14,7,7,16,4
Sat 8 Feb 2020 21:00,1,1,0,32,15,17,12,6,6,6,4
Sat 8 Feb 2020 22:00,3,1,2,25,19,6,12,5,7,19,6
Sat 8 Feb 2020 23:00,3,0,3,19,14,5,14,3,11,13,4
Sun 9 Feb 2020 00:00,0,0,0,18,10,8,7,2,5,10,1
Sun 9 Feb 2020 01:00,0,0,0,7,5,2,4,1,3,5,2
Sun 9 Feb 2020 02:00,1,1,0,4,4,0,0,0,0,8,1
Sun 9 Feb 2020 03:00,0,0,0,5,4,1,0,0,0,7,1
Sun 9 Feb 2020 04:00,0,0,0,3,1,2,1,1,0,2,2
Sun 9 Feb 2020 05:00,0,0,0,8,1,7,4,4,0,1,3
Sun 9 Feb 2020 06:00,0,0,0,15,2,13,10,10,0,4,12
Sun 9 Feb 2020 07:00,1,0,1,15,3,12,16,16,0,4,10
Sun 9 Feb 2020 08:00,1,1,0,16,1,15,11,11,0,2,8
Sun 9 Feb 2020 09:00,0,0,0,18,4,14,11,10,1,2,7
Sun 9 Feb 2020 10:00,0,0,0,33,6,27,10,8,2,9,11
Sun 9 Feb 2020 11:00,2,2,0,25,9,16,15,13,2,5,11
Sun 9 Feb 2020 12:00,3,1,2,37,14,23,17,16,1,7,12
Sun 9 Feb 2020 13:00,4,1,3,52,21,31,31,21,10,22,18
Sun 9 Feb 2020 14:00,1,1,0,44,26,18,12,6,6,13,6
Sun 9 Feb 2020 15:00,3,0,3,38,18,20,25,15,10,12,13
Sun 9 Feb 2020 16:00,1,1,0,38,21,17,15,10,5,13,6
Sun 9 Feb 2020 17:00,1,1,0,38,21,17,13,7,6,14,3
Sun 9 Feb 2020 18:00,0,0,0,26,12,14,22,16,6,13,9
Sun 9 Feb 2020 19:00,0,0,0,38,20,18,14,8,6,14,5
Sun 9 Feb 2020 20:00,3,2,1,26,14,12,12,5,7,10,0
Sun 9 Feb 2020 21:00,1,0,1,23,16,7,18,8,10,14,5
Sun 9 Feb 2020 22:00,1,1,0,18,10,8,6,3,3,9,2
Sun 9 Feb 2020 23:00,1,1,0,15,12,3,4,0,4,15,3
Mon 10 Feb 2020 00:00,0,0,0,5,4,1,1,1,0,2,1
Mon 10 Feb 2020 01:00,0,0,0,2,2,0,1,0,1,5,1
Mon 10 Feb 2020 02:00,0,0,0,7,7,0,0,0,0,0,3
Mon 10 Feb 2020 03:00,0,0,0,6,1,5,4,4,0,3,0
Mon 10 Feb 2020 04:00,0,0,0,10,0,10,7,7,0,3,5
Mon 10 Feb 2020 05:00,0,0,0,28,6,22,17,17,0,2,13
Mon 10 Feb 2020 06:00,5,5,0,114,6,108,129,127,2,10,72
Mon 10 Feb 2020 07:00,5,3,2,305,31,274,123,110,13,31,159
Mon 10 Feb 2020 08:00,33,24,9,803,72,731,297,277,20,45,372
Mon 10 Feb 2020 09:00,12,12,0,304,37,267,155,138,17,17,200
Mon 10 Feb 2020 10:00,3,1,2,74,20,54,32,25,7,13,41
Mon 10 Feb 2020 11:00,3,2,1,57,22,35,15,14,1,15,19
Mon 10 Feb 2020 12:00,1,1,0,75,23,52,31,20,11,37,29
Mon 10 Feb 2020 13:00,2,1,1,67,28,39,36,23,13,46,34
Mon 10 Feb 2020 14:00,5,3,2,72,34,38,29,21,8,25,10
Mon 10 Feb 2020 15:00,5,2,3,103,62,41,22,11,11,45,10
Mon 10 Feb 2020 16:00,7,4,3,189,130,59,67,29,38,145,31
Mon 10 Feb 2020 17:00,8,2,6,422,349,73,144,58,86,366,57
Mon 10 Feb 2020 18:00,9,3,6,396,317,79,114,37,77,280,20
Mon 10 Feb 2020 19:00,3,2,1,162,119,43,49,15,34,104,4
Mon 10 Feb 2020 20:00,2,1,1,92,69,23,32,11,21,44,9
Mon 10 Feb 2020 21:00,0,0,0,47,38,9,20,10,10,53,6
Mon 10 Feb 2020 22:00,3,3,0,36,26,10,23,6,17,29,6
Mon 10 Feb 2020 23:00,0,0,0,16,13,3,10,4,6,14,1
Tue 11 Feb 2020 00:00,0,0,0,12,8,4,3,2,1,9,1
Tue 11 Feb 2020 01:00,0,0,0,4,4,0,3,2,1,1,0
Tue 11 Feb 2020 02:00,0,0,0,6,5,1,2,2,0,2,0
Tue 11 Feb 2020 03:00,0,0,0,4,1,3,2,2,0,5,1
Tue 11 Feb 2020 04:00,1,0,1,8,1,7,5,5,0,2,5
Tue 11 Feb 2020 05:00,0,0,0,26,5,21,16,13,3,3,18
Tue 11 Feb 2020 06:00,5,4,1,121,13,108,137,135,2,9,64
Tue 11 Feb 2020 07:00,8,6,2,334,40,294,137,126,11,28,152
Tue 11 Feb 2020 08:00,24,19,5,813,98,715,265,247,18,34,289
Tue 11 Feb 2020 09:00,15,12,3,359,48,311,142,125,17,14,163
Tue 11 Feb 2020 10:00,5,4,1,92,20,72,36,35,1,7,54
Tue 11 Feb 2020 11:00,4,3,1,64,22,42,26,20,6,12,27
Tue 11 Feb 2020 12:00,5,3,2,77,27,50,24,18,6,26,26
Tue 11 Feb 2020 13:00,7,4,3,87,43,44,42,28,14,45,36
Tue 11 Feb 2020 14:00,4,2,2,73,35,38,38,26,12,44,24
Tue 11 Feb 2020 15:00,4,2,2,95,62,33,22,11,11,38,13
Tue 11 Feb 2020 16:00,8,5,3,234,155,79,60,27,33,175,29
Tue 11 Feb 2020 17:00,7,2,5,419,316,103,133,47,86,319,59
Tue 11 Feb 2020 18:00,9,2,7,381,318,63,107,35,72,175,25
Tue 11 Feb 2020 19:00,4,1,3,184,133,51,61,23,38,135,13
Tue 11 Feb 2020 20:00,5,3,2,101,63,38,39,12,27,52,6
Tue 11 Feb 2020 21:00,5,3,2,70,56,14,36,17,19,40,6
Tue 11 Feb 2020 22:00,0,0,0,47,35,12,22,4,18,34,5
Tue 11 Feb 2020 23:00,0,0,0,15,14,1,6,1,5,18,3
Wed 12 Feb 2020 00:00,0,0,0,16,12,4,5,1,4,7,0
Wed 12 Feb 2020 01:00,0,0,0,1,1,0,0,0,0,2,0
Wed 12 Feb 2020 02:00,0,0,0,9,8,1,1,0,1,5,1
Wed 12 Feb 2020 03:00,0,0,0,3,1,2,2,2,0,4,0
Wed 12 Feb 2020 04:00,0,0,0,11,1,10,5,5,0,3,6
Wed 12 Feb 2020 05:00,1,0,1,34,4,30,16,15,1,3,17
Wed 12 Feb 2020 06:00,3,2,1,128,16,112,127,125,2,13,79
Wed 12 Feb 2020 07:00,6,6,0,380,53,327,169,152,17,31,120
Wed 12 Feb 2020 08:00,22,19,3,880,99,781,304,285,19,40,346
Wed 12 Feb 2020 09:00,20,18,2,377,50,327,150,135,15,15,184
Wed 12 Feb 2020 10:00,5,3,2,109,21,88,39,35,4,11,42
Wed 12 Feb 2020 11:00,1,1,0,71,25,46,30,28,2,12,31
Wed 12 Feb 2020 12:00,4,3,1,105,34,71,42,28,14,51,50
Wed 12 Feb 2020 13:00,6,5,1,116,45,71,41,29,12,40,57
Wed 12 Feb 2020 14:00,7,2,5,101,49,52,51,31,20,39,39
Wed 12 Feb 2020 15:00,3,1,2,122,63,59,37,21,16,60,28
Wed 12 Feb 2020 16:00,3,2,1,227,155,72,74,34,40,160,42
Wed 12 Feb 2020 17:00,9,5,4,506,405,101,156,51,105,345,81
Wed 12 Feb 2020 18:00,8,3,5,420,337,83,139,40,99,294,43
Wed 12 Feb 2020 19:00,5,3,2,198,144,54,61,28,33,135,26
Wed 12 Feb 2020 20:00,4,3,1,129,89,40,61,20,41,59,2
Wed 12 Feb 2020 21:00,2,1,1,73,52,21,41,13,28,60,6
Wed 12 Feb 2020 22:00,6,1,5,60,48,12,18,7,11,38,3
Wed 12 Feb 2020 23:00,0,0,0,27,23,4,16,2,14,15,5
Thu 13 Feb 2020 00:00,2,2,0,11,8,3,3,1,2,7,3
Thu 13 Feb 2020 01:00,0,0,0,4,2,2,2,0,2,6,0
Thu 13 Feb 2020 02:00,0,0,0,7,4,3,1,0,1,2,0
Thu 13 Feb 2020 03:00,1,0,1,6,3,3,1,1,0,3,0
Thu 13 Feb 2020 04:00,0,0,0,7,2,5,8,8,0,0,3
Thu 13 Feb 2020 05:00,1,0,1,30,7,23,17,16,1,1,11
Thu 13 Feb 2020 06:00,5,4,1,140,16,124,132,130,2,11,76
Thu 13 Feb 2020 07:00,10,7,3,360,44,316,159,147,12,32,149
Thu 13 Feb 2020 08:00,32,29,3,942,104,838,305,288,17,46,292
Thu 13 Feb 2020 09:00,6,6,0,371,52,319,161,138,23,30,217
Thu 13 Feb 2020 10:00,3,1,2,99,26,73,37,31,6,11,64
Thu 13 Feb 2020 11:00,1,1,0,75,22,53,32,22,10,21,45
Thu 13 Feb 2020 12:00,6,4,2,77,31,46,44,31,13,38,51
Thu 13 Feb 2020 13:00,8,5,3,99,34,65,39,33,6,50,34
Thu 13 Feb 2020 14:00,5,2,3,103,48,55,52,34,18,56,28
Thu 13 Feb 2020 15:00,5,5,0,114,64,50,33,15,18,73,41
Thu 13 Feb 2020 16:00,10,7,3,241,153,88,81,38,43,154,43
Thu 13 Feb 2020 17:00,14,2,12,521,397,124,176,59,117,342,75
Thu 13 Feb 2020 18:00,10,4,6,468,359,109,113,38,75,251,33
Thu 13 Feb 2020 19:00,4,3,1,235,165,70,69,25,44,125,17
Thu 13 Feb 2020 20:00,5,2,3,140,92,48,45,22,23,93,14
Thu 13 Feb 2020 21:00,3,1,2,98,67,31,36,16,20,86,8
Thu 13 Feb 2020 22:00,0,0,0,70,49,21,18,2,16,53,10
Thu 13 Feb 2020 23:00,3,2,1,30,25,5,21,3,18,38,1
Fri 14 Feb 2020 00:00,4,2,2,18,16,2,4,2,2,15,3
Fri 14 Feb 2020 01:00,1,0,1,5,4,1,5,0,5,8,2
Fri 14 Feb 2020 02:00,1,1,0,9,7,2,3,1,2,5,0
Fri 14 Feb 2020 03:00,0,0,0,4,1,3,3,2,1,5,3
Fri 14 Feb 2020 04:00,0,0,0,19,8,11,4,4,0,6,4
Fri 14 Feb 2020 05:00,1,1,0,26,4,22,19,18,1,4,19
Fri 14 Feb 2020 06:00,6,5,1,123,12,111,126,121,5,14,66
Fri 14 Feb 2020 07:00,11,10,1,345,35,310,136,123,13,27,137
Fri 14 Feb 2020 08:00,27,22,5,738,71,667,290,262,28,45,311
Fri 14 Feb 2020 09:00,14,11,3,306,33,273,135,119,16,17,182
Fri 14 Feb 2020 10:00,4,2,2,75,18,57,37,32,5,12,48
Fri 14 Feb 2020 11:00,4,3,1,71,31,40,32,26,6,14,26
Fri 14 Feb 2020 12:00,3,3,0,87,33,54,41,22,19,48,43
Fri 14 Feb 2020 13:00,4,3,1,110,59,51,48,29,19,70,38
Fri 14 Feb 2020 14:00,6,6,0,129,66,63,44,27,17,45,25
Fri 14 Feb 2020 15:00,3,3,0,155,96,59,52,28,24,66,28
Fri 14 Feb 2020 16:00,12,5,7,243,162,81,88,36,52,137,37
Fri 14 Feb 2020 17:00,9,4,5,493,380,113,159,57,102,276,54
Fri 14 Feb 2020 18:00,5,3,2,336,243,93,80,23,57,208,34
Fri 14 Feb 2020 19:00,5,3,2,174,115,59,50,17,33,92,17
Fri 14 Feb 2020 20:00,5,4,1,105,64,41,39,28,11,61,9
Fri 14 Feb 2020 21:00,1,1,0,52,33,19,25,6,19,51,10
Fri 14 Feb 2020 22:00,1,0,1,47,36,11,16,6,10,26,8
Fri 14 Feb 2020 23:00,1,1,0,43,29,14,15,3,12,22,5
Sat 15 Feb 2020 00:00,0,0,0,26,21,5,8,0,8,16,9
Sat 15 Feb 2020 01:00,4,2,2,15,13,2,4,0,4,14,4
Sat 15 Feb 2020 02:00,0,0,0,8,7,1,4,0,4,9,3
Sat 15 Feb 2020 03:00,0,0,0,8,7,1,1,0,1,6,0
Sat 15 Feb 2020 04:00,0,0,0,7,4,3,6,5,1,6,4
Sat 15 Feb 2020 05:00,1,0,1,13,3,10,9,9,0,4,5
Sat 15 Feb 2020 06:00,1,1,0,29,6,23,16,16,0,9,14
Sat 15 Feb 2020 07:00,1,1,0,35,6,29,36,34,2,4,22
Sat 15 Feb 2020 08:00,1,1,0,50,12,38,22,20,2,8,19
Sat 15 Feb 2020 09:00,3,3,0,61,31,30,21,19,2,9,20
Sat 15 Feb 2020 10:00,0,0,0,39,12,27,19,13,6,14,22
Sat 15 Feb 2020 11:00,3,1,2,39,14,25,18,16,2,12,23
Sat 15 Feb 2020 12:00,0,0,0,48,21,27,16,15,1,24,25
Sat 15 Feb 2020 13:00,3,2,1,61,39,22,27,14,13,17,26
Sat 15 Feb 2020 14:00,2,0,2,38,22,16,9,5,4,18,13
Sat 15 Feb 2020 15:00,2,2,0,46,22,24,22,12,10,18,9
Sat 15 Feb 2020 16:00,2,2,0,58,26,32,23,13,10,20,8
Sat 15 Feb 2020 17:00,3,2,1,57,33,24,22,13,9,17,2
Sat 15 Feb 2020 18:00,0,0,0,54,24,30,20,12,8,24,12
Sat 15 Feb 2020 19:00,0,0,0,34,13,21,20,12,8,18,7
Sat 15 Feb 2020 20:00,2,1,1,40,23,17,16,10,6,19,8
Sat 15 Feb 2020 21:00,3,1,2,15,9,6,19,10,9,21,10
Sat 15 Feb 2020 22:00,1,0,1,22,12,10,9,5,4,13,7
Sat 15 Feb 2020 23:00,2,2,0,17,12,5,7,0,7,10,2
Sun 16 Feb 2020 00:00,2,1,1,13,12,1,5,1,4,11,4
Sun 16 Feb 2020 01:00,1,0,1,11,8,3,2,0,2,11,2
Sun 16 Feb 2020 02:00,2,1,1,8,6,2,0,0,0,4,1
Sun 16 Feb 2020 03:00,0,0,0,3,2,1,1,0,1,3,1
Sun 16 Feb 2020 04:00,1,0,1,4,1,3,0,0,0,5,3
Sun 16 Feb 2020 05:00,0,0,0,8,4,4,7,7,0,4,2
Sun 16 Feb 2020 06:00,1,1,0,20,4,16,9,9,0,15,9
Sun 16 Feb 2020 07:00,1,1,0,19,3,16,17,14,3,6,8
Sun 16 Feb 2020 08:00,2,2,0,24,5,19,14,13,1,3,28
Sun 16 Feb 2020 09:00,1,0,1,49,13,36,13,12,1,8,15
Sun 16 Feb 2020 10:00,2,1,1,56,12,44,23,13,10,7,21
Sun 16 Feb 2020 11:00,3,2,1,43,11,32,25,18,7,12,19
Sun 16 Feb 2020 12:00,2,2,0,71,29,42,23,16,7,12,16
Sun 16 Feb 2020 13:00,1,1,0,59,30,29,35,18,17,27,19
Sun 16 Feb 2020 14:00,3,2,1,39,17,22,27,15,12,10,11
Sun 16 Feb 2020 15:00,3,0,3,53,23,30,26,15,11,21,14
Sun 16 Feb 2020 16:00,4,3,1,47,24,23,31,18,13,29,6
Sun 16 Feb 2020 17:00,0,0,0,48,28,20,15,7,8,29,5
Sun 16 Feb 2020 18:00,2,2,0,49,23,26,26,11,15,34,16
Sun 16 Feb 2020 19:00,1,0,1,42,21,21,15,9,6,28,10
Sun 16 Feb 2020 20:00,2,1,1,33,20,13,15,8,7,14,3
Sun 16 Feb 2020 21:00,5,2,3,36,21,15,14,9,5,12,0
Sun 16 Feb 2020 22:00,2,1,1,26,21,5,9,6,3,20,5
Sun 16 Feb 2020 23:00,0,0,0,11,5,6,7,2,5,10,4
Mon 17 Feb 2020 00:00,0,0,0,9,8,1,2,0,2,7,3
Mon 17 Feb 2020 01:00,0,0,0,5,4,1,1,0,1,1,0
Mon 17 Feb 2020 02:00,1,1,0,3,2,1,0,0,0,2,1
Mon 17 Feb 2020 03:00,0,0,0,3,1,2,3,3,0,2,2
Mon 17 Feb 2020 04:00,0,0,0,9,3,6,8,7,1,4,5
Mon 17 Feb 2020 05:00,0,0,0,31,4,27,18,17,1,4,11
Mon 17 Feb 2020 06:00,4,3,1,131,17,114,119,116,3,6,84
Mon 17 Feb 2020 07:00,16,15,1,357,56,301,170,155,15,29,189
Mon 17 Feb 2020 08:00,39,36,3,853,67,786,337,312,25,51,384
Mon 17 Feb 2020 09:00,12,11,1,299,30,269,156,139,17,17,212
Mon 17 Feb 2020 10:00,6,5,1,75,15,60,45,40,5,15,66
Mon 17 Feb 2020 11:00,3,3,0,66,24,42,24,20,4,17,32
Mon 17 Feb 2020 12:00,2,1,1,63,21,42,37,27,10,27,44
Mon 17 Feb 2020 13:00,1,0,1,81,26,55,37,21,16,42,37
Mon 17 Feb 2020 14:00,1,0,1,64,30,34,24,18,6,29,25
Mon 17 Feb 2020 15:00,1,1,0,113,69,44,35,14,21,44,16
Mon 17 Feb 2020 16:00,10,5,5,173,114,59,67,31,36,150,44
Mon 17 Feb 2020 17:00,10,4,6,578,477,101,142,53,89,315,51
Mon 17 Feb 2020 18:00,11,7,4,430,330,100,145,40,105,343,42
Mon 17 Feb 2020 19:00,5,3,2,184,131,53,60,19,41,112,5
Mon 17 Feb 2020 20:00,3,3,0,103,70,33,39,19,20,78,7
Mon 17 Feb 2020 21:00,3,3,0,71,49,22,26,12,14,38,10
Mon 17 Feb 2020 22:00,3,3,0,55,37,18,27,9,18,32,6
Mon 17 Feb 2020 23:00,0,0,0,23,14,9,11,4,7,21,2
Tue 18 Feb 2020 00:00,1,1,0,12,9,3,2,1,1,2,2
Tue 18 Feb 2020 01:00,0,0,0,7,6,1,1,0,1,1,0
Tue 18 Feb 2020 02:00,0,0,0,3,3,0,0,0,0,8,1
Tue 18 Feb 2020 03:00,0,0,0,4,1,3,3,3,0,3,4
Tue 18 Feb 2020 04:00,1,0,1,7,1,6,6,6,0,3,5
Tue 18 Feb 2020 05:00,1,1,0,31,6,25,19,17,2,5,15
Tue 18 Feb 2020 06:00,6,5,1,126,16,110,123,121,2,8,56
Tue 18 Feb 2020 07:00,11,8,3,344,46,298,158,148,10,25,165
Tue 18 Feb 2020 08:00,35,30,5,833,49,784,324,307,17,44,337
Tue 18 Feb 2020 09:00,15,12,3,319,34,285,151,132,19,13,189
Tue 18 Feb 2020 10:00,3,3,0,89,18,71,38,31,7,11,52
Tue 18 Feb 2020 11:00,4,4,0,59,18,41,29,23,6,17,28
Tue 18 Feb 2020 12:00,6,5,1,78,25,53,42,29,13,37,39
Tue 18 Feb 2020 13:00,5,5,0,70,32,38,46,32,14,39,19
Tue 18 Feb 2020 14:00,4,2,2,64,32,32,14,11,3,17,17
Tue 18 Feb 2020 15:00,3,0,3,102,63,39,32,17,15,35,23
Tue 18 Feb 2020 16:00,11,6,5,193,122,71,69,31,38,150,52
Tue 18 Feb 2020 17:00,15,7,8,510,392,118,151,56,95,334,73
Tue 18 Feb 2020 18:00,12,6,6,449,339,110,125,39,86,291,42
Tue 18 Feb 2020 19:00,4,3,1,221,155,66,64,28,36,134,12
Tue 18 Feb 2020 20:00,5,2,3,124,92,32,39,15,24,91,12
Tue 18 Feb 2020 21:00,4,2,2,92,62,30,38,13,25,57,9
Tue 18 Feb 2020 22:00,0,0,0,54,33,21,25,6,19,44,4
Tue 18 Feb 2020 23:00,3,2,1,31,24,7,13,2,11,17,4
Wed 19 Feb 2020 00:00,2,1,1,16,14,2,5,1,4,9,4
Wed 19 Feb 2020 01:00,0,0,0,10,6,4,1,1,0,3,0
Wed 19 Feb 2020 02:00,0,0,0,5,5,0,0,0,0,3,2
Wed 19 Feb 2020 03:00,0,0,0,7,3,4,2,2,0,4,3
Wed 19 Feb 2020 04:00,0,0,0,5,0,5,6,6,0,1,8
Wed 19 Feb 2020 05:00,0,0,0,42,13,29,18,17,1,2,21
Wed 19 Feb 2020 06:00,3,3,0,127,14,113,143,139,4,16,81
Wed 19 Feb 2020 07:00,11,9,2,376,51,325,158,141,17,28,199
Wed 19 Feb 2020 08:00,34,29,5,819,80,739,278,259,19,32,366
Wed 19 Feb 2020 09:00,10,8,2,360,47,313,129,115,14,16,129
Wed 19 Feb 2020 10:00,4,2,2,83,19,64,28,21,7,9,49
Wed 19 Feb 2020 11:00,4,4,0,59,13,46,36,32,4,6,25
Wed 19 Feb 2020 12:00,4,2,2,70,27,43,32,21,11,31,29
Wed 19 Feb 2020 13:00,6,4,2,99,38,61,39,22,17,29,29
Wed 19 Feb 2020 14:00,6,3,3,84,36,48,25,15,10,33,24
Wed 19 Feb 2020 15:00,2,2,0,104,56,48,45,19,26,44,16
Wed 19 Feb 2020 16:00,9,8,1,196,118,78,64,24,40,109,34
Wed 19 Feb 2020 17:00,10,6,4,482,393,89,154,50,104,295,71
Wed 19 Feb 2020 18:00,12,7,5,469,383,86,127,42,85,251,37
Wed 19 Feb 2020 19:00,4,0,4,177,130,47,60,25,35,115,8
Wed 19 Feb 2020 20:00,2,2,0,123,81,42,35,13,22,69,4
Wed 19 Feb 2020 21:00,2,1,1,59,41,18,31,13,18,64,1
Wed 19 Feb 2020 22:00,4,2,2,69,53,16,21,9,12,31,3
Wed 19 Feb 2020 23:00,0,0,0,45,34,11,14,4,10,24,6
Thu 20 Feb 2020 00:00,0,0,0,17,13,4,6,1,5,11,1
Thu 20 Feb 2020 01:00,1,0,1,6,3,3,2,2,0,2,0
Thu 20 Feb 2020 02:00,0,0,0,5,5,0,2,2,0,2,3
Thu 20 Feb 2020 03:00,0,0,0,3,1,2,1,1,0,5,1
Thu 20 Feb 2020 04:00,0,0,0,9,3,6,5,5,0,4,6
Thu 20 Feb 2020 05:00,0,0,0,28,5,23,21,21,0,2,15
Thu 20 Feb 2020 06:00,4,4,0,106,12,94,123,121,2,15,54
Thu 20 Feb 2020 07:00,7,4,3,325,41,284,141,130,11,24,159
Thu 20 Feb 2020 08:00,31,30,1,767,64,703,292,269,23,45,311
Thu 20 Feb 2020 09:00,5,4,1,350,35,315,155,139,16,30,159
Thu 20 Feb 2020 10:00,4,2,2,87,18,69,36,32,4,17,58
Thu 20 Feb 2020 11:00,5,4,1,75,30,45,26,22,4,21,42
Thu 20 Feb 2020 12:00,2,1,1,93,29,64,31,21,10,41,54
Thu 20 Feb 2020 13:00,2,2,0,100,40,60,48,37,11,39,43
Thu 20 Feb 2020 14:00,3,0,3,70,39,31,29,17,12,28,24
Thu 20 Feb 2020 15:00,6,2,4,96,55,41,37,19,18,32,17
Thu 20 Feb 2020 16:00,11,4,7,187,117,70,77,32,45,118,38
Thu 20 Feb 2020 17:00,9,5,4,447,344,103,152,56,96,249,44
Thu 20 Feb 2020 18:00,6,3,3,402,305,97,101,33,68,235,37
Thu 20 Feb 2020 19:00,3,3,0,214,139,75,57,20,37,115,25
Thu 20 Feb 2020 20:00,4,2,2,133,91,42,44,23,21,78,9
Thu 20 Feb 2020 21:00,6,3,3,76,58,18,25,9,16,56,6
Thu 20 Feb 2020 22:00,1,1,0,61,42,19,26,8,18,25,3
Thu 20 Feb 2020 23:00,2,1,1,34,22,12,8,1,7,39,6
Fri 21 Feb 2020 00:00,2,1,1,26,22,4,7,4,3,15,9
Fri 21 Feb 2020 01:00,5,4,1,7,7,0,3,1,2,5,1
Fri 21 Feb 2020 02:00,1,0,1,4,3,1,1,1,0,3,1
Fri 21 Feb 2020 03:00,2,0,2,4,2,2,2,2,0,5,0
Fri 21 Feb 2020 04:00,1,1,0,10,4,6,4,4,0,3,4
Fri 21 Feb 2020 05:00,2,2,0,34,8,26,23,23,0,8,17
Fri 21 Feb 2020 06:00,5,5,0,135,13,122,106,105,1,14,63
Fri 21 Feb 2020 07:00,7,7,0,308,34,274,124,113,11,30,122
Fri 21 Feb 2020 08:00,26,24,2,631,55,576,245,229,16,26,306
Fri 21 Feb 2020 09:00,7,5,2,267,23,244,109,99,10,24,169
Fri 21 Feb 2020 10:00,2,2,0,79,18,61,40,33,7,13,44
Fri 21 Feb 2020 11:00,5,2,3,85,29,56,38,34,4,25,30
Fri 21 Feb 2020 12:00,3,3,0,77,28,49,33,24,9,40,40
Fri 21 Feb 2020 13:00,3,0,3,100,48,52,47,35,12,53,30
Fri 21 Feb 2020 14:00,14,7,7,96,49,47,39,21,18,47,33
Fri 21 Feb 2020 15:00,1,1,0,105,56,49,47,22,25,61,29
Fri 21 Feb 2020 16:00,6,4,2,207,134,73,78,29,49,115,47
Fri 21 Feb 2020 17:00,8,1,7,403,302,101,129,46,83,231,52
Fri 21 Feb 2020 18:00,4,3,1,274,214,60,85,29,56,177,36
Fri 21 Feb 2020 19:00,4,1,3,157,102,55,44,15,29,75,15
Fri 21 Feb 2020 20:00,4,2,2,89,59,30,26,11,15,50,12
Fri 21 Feb 2020 21:00,5,4,1,52,35,17,28,7,21,43,9
Fri 21 Feb 2020 22:00,1,1,0,45,33,12,22,7,15,27,11
Fri 21 Feb 2020 23:00,1,1,0,36,29,7,12,3,9,37,5
Sat 22 Feb 2020 00:00,0,0,0,24,16,8,3,0,3,16,2
Sat 22 Feb 2020 01:00,1,1,0,12,10,2,3,0,3,10,4
Sat 22 Feb 2020 02:00,1,0,1,6,4,2,3,1,2,7,2
Sat 22 Feb 2020 03:00,0,0,0,10,7,3,0,0,0,6,1
Sat 22 Feb 2020 04:00,2,1,1,4,1,3,3,3,0,5,7
Sat 22 Feb 2020 05:00,0,0,0,16,2,14,5,5,0,4,5
Sat 22 Feb 2020 06:00,0,0,0,33,4,29,21,20,1,7,21
Sat 22 Feb 2020 07:00,1,1,0,49,9,40,30,29,1,4,14
Sat 22 Feb 2020 08:00,7,6,1,56,10,46,28,25,3,5,22
Sat 22 Feb 2020 09:00,4,3,1,75,15,60,35,26,9,17,35
Sat 22 Feb 2020 10:00,4,1,3,75,38,37,20,16,4,17,36
Sat 22 Feb 2020 11:00,1,1,0,65,29,36,23,14,9,31,27
Sat 22 Feb 2020 12:00,3,3,0,78,34,44,25,17,8,28,27
Sat 22 Feb 2020 13:00,5,1,4,78,36,42,36,19,17,41,31
Sat 22 Feb 2020 14:00,3,1,2,87,38,49,39,29,10,33,20
Sat 22 Feb 2020 15:00,2,0,2,77,37,40,27,14,13,37,12
Sat 22 Feb 2020 16:00,5,5,0,54,20,34,35,24,11,43,13
Sat 22 Feb 2020 17:00,1,1,0,79,31,48,28,15,13,19,5
Sat 22 Feb 2020 18:00,4,2,2,65,32,33,22,13,9,32,17
Sat 22 Feb 2020 19:00,2,1,1,58,31,27,27,19,8,31,16
Sat 22 Feb 2020 20:00,2,1,1,38,13,25,24,14,10,29,16
Sat 22 Feb 2020 21:00,3,1,2,31,19,12,17,12,5,27,9
Sat 22 Feb 2020 22:00,2,2,0,22,14,8,9,5,4,13,5
Sat 22 Feb 2020 23:00,1,1,0,30,24,6,9,3,6,17,8
Sun 23 Feb 2020 00:00,1,1,0,21,16,5,7,1,6,8,1
Sun 23 Feb 2020 01:00,2,1,1,7,6,1,2,0,2,7,1
Sun 23 Feb 2020 02:00,0,0,0,11,10,1,1,0,1,7,6
Sun 23 Feb 2020 03:00,1,1,0,13,9,4,3,2,1,4,2
Sun 23 Feb 2020 04:00,1,0,1,5,2,3,1,0,1,1,0
Sun 23 Feb 2020 05:00,0,0,0,11,3,8,1,1,0,4,10
Sun 23 Feb 2020 06:00,1,1,0,18,3,15,18,17,1,8,14
Sun 23 Feb 2020 07:00,2,1,1,36,11,25,18,17,1,4,17
Sun 23 Feb 2020 08:00,2,1,1,30,9,21,14,13,1,10,15
Sun 23 Feb 2020 09:00,2,1,1,47,14,33,27,19,8,14,21
Sun 23 Feb 2020 10:00,1,1,0,65,16,49,20,15,5,20,19
Sun 23 Feb 2020 11:00,1,1,0,68,25,43,30,22,8,23,25
Sun 23 Feb 2020 12:00,4,3,1,71,26,45,38,25,13,30,27
Sun 23 Feb 2020 13:00,4,3,1,89,46,43,37,26,11,34,51
Sun 23 Feb 2020 14:00,1,0,1,90,36,54,43,33,10,25,26
Sun 23 Feb 2020 15:00,3,3,0,62,26,36,31,24,7,28,25
Sun 23 Feb 2020 16:00,2,1,1,59,25,34,36,19,17,25,20
Sun 23 Feb 2020 17:00,3,2,1,65,28,37,29,14,15,34,14
Sun 23 Feb 2020 18:00,3,2,1,66,37,29,28,13,15,31,16
Sun 23 Feb 2020 19:00,2,1,1,68,42,26,27,12,15,36,9
Sun 23 Feb 2020 20:00,4,1,3,55,29,26,22,9,13,29,4
Sun 23 Feb 2020 21:00,2,1,1,33,18,15,17,7,10,27,6
Sun 23 Feb 2020 22:00,2,1,1,24,15,9,16,6,10,14,3
Sun 23 Feb 2020 23:00,1,0,1,16,12,4,6,0,6,18,4
Mon 24 Feb 2020 00:00,0,0,0,7,4,3,4,1,3,5,1
Mon 24 Feb 2020 01:00,0,0,0,1,1,0,0,0,0,3,2
Mon 24 Feb 2020 02:00,0,0,0,2,2,0,0,0,0,0,1
Mon 24 Feb 2020 03:00,0,0,0,4,2,2,2,2,0,1,0
Mon 24 Feb 2020 04:00,0,0,0,8,2,6,6,6,0,4,7
Mon 24 Feb 2020 05:00,0,0,0,27,6,21,13,11,2,2,19
Mon 24 Feb 2020 06:00,2,2,0,126,19,107,124,122,2,15,71
Mon 24 Feb 2020 07:00,10,8,2,348,44,304,165,155,10,32,139
Mon 24 Feb 2020 08:00,38,35,3,822,78,744,303,280,23,43,370
Mon 24 Feb 2020 09:00,12,12,0,349,38,311,144,126,18,28,192
Mon 24 Feb 2020 10:00,1,1,0,89,23,66,35,33,2,14,54
Mon 24 Feb 2020 11:00,4,3,1,65,13,52,18,15,3,4,20
Mon 24 Feb 2020 12:00,5,2,3,66,24,42,37,29,8,33,39
Mon 24 Feb 2020 13:00,2,1,1,90,40,50,23,17,6,43,29
Mon 24 Feb 2020 14:00,2,1,1,79,35,44,37,24,13,37,26
Mon 24 Feb 2020 15:00,3,2,1,82,49,33,39,24,15,51,30
Mon 24 Feb 2020 16:00,8,5,3,207,137,70,70,39,31,163,33
Mon 24 Feb 2020 17:00,15,6,9,527,432,95,168,51,117,366,64
Mon 24 Feb 2020 18:00,11,3,8,438,349,89,126,37,89,272,35
Mon 24 Feb 2020 19:00,7,4,3,172,128,44,83,29,54,87,20
Mon 24 Feb 2020 20:00,3,2,1,121,85,36,43,23,20,67,14
Mon 24 Feb 2020 21:00,5,2,3,68,48,20,30,8,22,39,8
Mon 24 Feb 2020 22:00,1,0,1,45,34,11,27,15,12,24,9
Mon 24 Feb 2020 23:00,1,1,0,28,23,5,8,3,5,19,3
Tue 25 Feb 2020 00:00,0,0,0,17,9,8,1,0,1,6,1
Tue 25 Feb 2020 01:00,0,0,0,3,3,0,1,1,0,5,1
Tue 25 Feb 2020 02:00,0,0,0,6,6,0,0,0,0,2,0
Tue 25 Feb 2020 03:00,0,0,0,3,2,1,2,1,1,5,2
Tue 25 Feb 2020 04:00,0,0,0,6,0,6,7,7,0,2,5
Tue 25 Feb 2020 05:00,1,0,1,41,7,34,15,15,0,6,24
Tue 25 Feb 2020 06:00,4,4,0,142,26,116,132,127,5,17,90
Tue 25 Feb 2020 07:00,16,13,3,427,79,348,176,164,12,43,209
Tue 25 Feb 2020 08:00,37,33,4,1035,88,947,355,328,27,48,328
Tue 25 Feb 2020 09:00,22,21,1,390,64,326,162,141,21,32,222
Tue 25 Feb 2020 10:00,8,5,3,95,17,78,50,46,4,11,47
Tue 25 Feb 2020 11:00,3,3,0,82,24,58,21,20,1,14,39
Tue 25 Feb 2020 12:00,3,2,1,101,36,65,38,23,15,36,52
Tue 25 Feb 2020 13:00,5,3,2,108,51,57,34,22,12,48,25
Tue 25 Feb 2020 14:00,5,4,1,104,46,58,30,23,7,43,24
Tue 25 Feb 2020 15:00,6,4,2,116,57,59,42,26,16,50,24
Tue 25 Feb 2020 16:00,11,6,5,264,190,74,94,42,52,172,34
Tue 25 Feb 2020 17:00,10,1,9,532,423,109,175,63,112,389,61
Tue 25 Feb 2020 18:00,8,3,5,474,366,108,122,34,88,341,49
Tue 25 Feb 2020 19:00,4,0,4,225,160,65,78,25,53,130,9
Tue 25 Feb 2020 20:00,8,5,3,118,85,33,52,21,31,73,4
Tue 25 Feb 2020 21:00,2,1,1,84,57,27,23,16,7,58,16
Tue 25 Feb 2020 22:00,0,0,0,61,46,15,19,7,12,34,6
Tue 25 Feb 2020 23:00,1,1,0,44,31,13,12,4,8,24,9
Wed 26 Feb 2020 00:00,1,0,1,13,11,2,2,1,1,16,1
Wed 26 Feb 2020 01:00,0,0,0,8,6,2,0,0,0,2,1
Wed 26 Feb 2020 02:00,0,0,0,4,3,1,0,0,0,6,0
Wed 26 Feb 2020 03:00,1,0,1,6,4,2,2,2,0,5,2
Wed 26 Feb 2020 04:00,1,1,0,6,1,5,7,6,1,5,6
Wed 26 Feb 2020 05:00,0,0,0,41,11,30,23,23,0,1,17
Wed 26 Feb 2020 06:00,3,2,1,134,20,114,131,125,6,19,81
Wed 26 Feb 2020 07:00,10,10,0,362,43,319,175,162,13,34,208
Wed 26 Feb 2020 08:00,34,31,3,891,67,824,325,299,26,56,387
Wed 26 Feb 2020 09:00,22,20,2,367,42,325,162,139,23,29,161
Wed 26 Feb 2020 10:00,3,0,3,103,21,82,45,38,7,11,51
Wed 26 Feb 2020 11:00,1,1,0,66,18,48,34,29,5,16,52
Wed 26 Feb 2020 12:00,2,1,1,90,38,52,33,25,8,33,39
Wed 26 Feb 2020 13:00,3,2,1,134,67,67,38,22,16,42,36
Wed 26 Feb 2020 14:00,4,1,3,96,42,54,46,28,18,52,19
Wed 26 Feb 2020 15:00,5,4,1,108,63,45,40,19,21,67,30
Wed 26 Feb 2020 16:00,6,2,4,218,149,69,86,38,48,149,38
Wed 26 Feb 2020 17:00,11,4,7,536,412,124,178,61,117,390,56
Wed 26 Feb 2020 18:00,11,7,4,454,357,97,130,43,87,268,34
Wed 26 Feb 2020 19:00,6,4,2,227,162,65,52,20,32,134,10
Wed 26 Feb 2020 20:00,4,3,1,143,86,57,38,17,21,90,1
Wed 26 Feb 2020 21:00,5,4,1,73,56,17,37,18,19,66,10
Wed 26 Feb 2020 22:00,2,1,1,82,61,21,21,11,10,41,2
Wed 26 Feb 2020 23:00,2,1,1,41,31,10,13,2,11,35,4
Thu 27 Feb 2020 00:00,1,1,0,21,16,5,3,1,2,13,1
Thu 27 Feb 2020 01:00,0,0,0,5,3,2,0,0,0,5,1
Thu 27 Feb 2020 02:00,1,1,0,4,4,0,1,1,0,5,0
Thu 27 Feb 2020 03:00,1,0,1,7,4,3,0,0,0,5,2
Thu 27 Feb 2020 04:00,0,0,0,13,4,9,8,8,0,1,10
Thu 27 Feb 2020 05:00,1,0,1,32,8,24,23,22,1,6,17
Thu 27 Feb 2020 06:00,5,4,1,125,10,115,135,132,3,19,105
Thu 27 Feb 2020 07:00,11,10,1,376,51,325,166,153,13,26,180
Thu 27 Feb 2020 08:00,33,29,4,985,95,890,323,296,27,52,401
Thu 27 Feb 2020 09:00,13,11,2,355,47,308,164,141,23,23,178
Thu 27 Feb 2020 10:00,2,2,0,104,20,84,46,40,6,24,58
Thu 27 Feb 2020 11:00,4,4,0,68,14,54,35,29,6,14,34
Thu 27 Feb 2020 12:00,9,8,1,103,31,72,66,42,24,40,55
Thu 27 Feb 2020 13:00,3,2,1,114,54,60,43,29,14,48,42
Thu 27 Feb 2020 14:00,4,2,2,104,47,57,35,18,17,57,31
Thu 27 Feb 2020 15:00,3,2,1,123,71,52,44,19,25,69,33
Thu 27 Feb 2020 16:00,10,6,4,248,161,87,79,41,38,171,44
Thu 27 Feb 2020 17:00,10,2,8,468,373,95,173,66,107,355,62
Thu 27 Feb 2020 18:00,10,3,7,441,343,98,126,42,84,274,43
Thu 27 Feb 2020 19:00,5,2,3,221,164,57,75,25,50,149,28
Thu 27 Feb 2020 20:00,5,3,2,143,106,37,41,17,24,96,17
Thu 27 Feb 2020 21:00,0,0,0,86,58,28,41,16,25,69,7
Thu 27 Feb 2020 22:00,3,3,0,73,50,23,29,9,20,49,5
Thu 27 Feb 2020 23:00,4,4,0,42,31,11,13,1,12,32,13
Fri 28 Feb 2020 00:00,1,0,1,24,21,3,5,1,4,15,1
Fri 28 Feb 2020 01:00,0,0,0,5,5,0,1,1,0,6,1
Fri 28 Feb 2020 02:00,0,0,0,5,5,0,1,1,0,7,1
Fri 28 Feb 2020 03:00,1,0,1,1,1,0,3,3,0,4,0
Fri 28 Feb 2020 04:00,1,1,0,12,3,9,7,5,2,3,4
Fri 28 Feb 2020 05:00,2,1,1,34,10,24,21,20,1,6,23
Fri 28 Feb 2020 06:00,4,3,1,109,11,98,119,115,4,11,70
Fri 28 Feb 2020 07:00,8,7,1,308,45,263,129,121,8,18,146
Fri 28 Feb 2020 08:00,22,21,1,677,72,605,250,232,18,36,267
Fri 28 Feb 2020 09:00,13,12,1,323,32,291,130,119,11,23,124
Fri 28 Feb 2020 10:00,3,3,0,83,17,66,34,29,5,20,49
Fri 28 Feb 2020 11:00,3,2,1,86,24,62,35,25,10,18,36
Fri 28 Feb 2020 12:00,6,4,2,119,48,71,40,24,16,50,35
Fri 28 Feb 2020 13:00,2,2,0,101,37,64,37,24,13,51,40
Fri 28 Feb 2020 14:00,2,1,1,99,49,50,50,32,18,66,42
Fri 28 Feb 2020 15:00,6,4,2,127,71,56,44,25,19,75,32
Fri 28 Feb 2020 16:00,12,5,7,238,154,84,80,32,48,132,48
Fri 28 Feb 2020 17:00,5,1,4,439,342,97,131,58,73,265,69
Fri 28 Feb 2020 18:00,5,4,1,269,202,67,95,33,62,177,34
Fri 28 Feb 2020 19:00,3,1,2,136,83,53,59,25,34,92,34
Fri 28 Feb 2020 20:00,4,4,0,93,62,31,30,16,14,58,14
Fri 28 Feb 2020 21:00,1,0,1,50,28,22,21,9,12,53,19
Fri 28 Feb 2020 22:00,1,1,0,70,42,28,32,12,20,29,14
Fri 28 Feb 2020 23:00,1,1,0,56,43,13,23,6,17,28,5
Sat 29 Feb 2020 00:00,0,0,0,40,28,12,14,2,12,15,3
Sat 29 Feb 2020 01:00,0,0,0,13,9,4,7,3,4,5,0
Sat 29 Feb 2020 02:00,0,0,0,10,7,3,1,0,1,10,0
Sat 29 Feb 2020 03:00,0,0,0,11,6,5,2,1,1,9,2
Sat 29 Feb 2020 04:00,1,0,1,10,5,5,3,2,1,2,7
Sat 29 Feb 2020 05:00,1,1,0,12,0,12,4,4,0,3,8
Sat 29 Feb 2020 06:00,0,0,0,33,8,25,22,21,1,15,16
Sat 29 Feb 2020 07:00,1,1,0,58,15,43,40,40,0,6,29
Sat 29 Feb 2020 08:00,2,2,0,59,10,49,28,25,3,16,29
Sat 29 Feb 2020 09:00,6,5,1,82,16,66,49,44,5,20,44
Sat 29 Feb 2020 10:00,1,1,0,70,26,44,30,16,14,16,23
Sat 29 Feb 2020 11:00,3,2,1,54,10,44,28,23,5,22,29
Sat 29 Feb 2020 12:00,4,2,2,72,18,54,34,19,15,37,33
Sat 29 Feb 2020 13:00,4,1,3,69,32,37,30,16,14,34,25
Sat 29 Feb 2020 14:00,5,1,4,68,37,31,22,14,8,24,22
Sat 29 Feb 2020 15:00,3,3,0,44,15,29,24,12,12,22,11
Sat 29 Feb 2020 16:00,3,2,1,35,16,19,19,14,5,24,14
Sat 29 Feb 2020 17:00,1,0,1,51,29,22,23,14,9,20,9
Sat 29 Feb 2020 18:00,0,0,0,40,20,20,25,13,12,26,9
Sat 29 Feb 2020 19:00,0,0,0,49,22,27,9,5,4,21,11
Sat 29 Feb 2020 20:00,3,3,0,38,20,18,12,8,4,17,6
Sat 29 Feb 2020 21:00,2,1,1,19,9,10,13,10,3,2,5
Sat 29 Feb 2020 22:00,0,0,0,31,14,17,11,6,5,13,3
Sat 29 Feb 2020 23:00,1,0,1,18,8,10,7,1,6,8,2
Sun 1 Mar 2020 00:00,1,1,0,18,11,7,7,0,7,10,3
Sun 1 Mar 2020 01:00,0,0,0,6,5,1,2,0,2,7,3
Sun 1 Mar 2020 02:00,0,0,0,15,6,9,0,0,0,6,0
Sun 1 Mar 2020 03:00,1,0,1,3,3,0,1,1,0,5,1
Sun 1 Mar 2020 04:00,0,0,0,12,4,8,2,1,1,1,1
Sun 1 Mar 2020 05:00,2,1,1,6,1,5,4,3,1,1,4
Sun 1 Mar 2020 06:00,0,0,0,21,5,16,15,12,3,5,11
Sun 1 Mar 2020 07:00,0,0,0,38,14,24,8,8,0,8,14
Sun 1 Mar 2020 08:00,1,0,1,24,3,21,20,20,0,8,4
Sun 1 Mar 2020 09:00,4,1,3,46,16,30,12,10,2,14,21
Sun 1 Mar 2020 10:00,4,4,0,61,18,43,30,20,10,15,24
Sun 1 Mar 2020 11:00,3,3,0,56,17,39,24,19,5,21,22
Sun 1 Mar 2020 12:00,2,1,1,72,22,50,20,15,5,22,21
Sun 1 Mar 2020 13:00,3,3,0,47,25,22,42,30,12,21,33
Sun 1 Mar 2020 14:00,2,2,0,75,34,41,33,17,16,31,28
Sun 1 Mar 2020 15:00,1,1,0,62,29,33,16,7,9,23,20
Sun 1 Mar 2020 16:00,6,2,4,59,31,28,29,16,13,39,13
Sun 1 Mar 2020 17:00,4,3,1,63,24,39,26,21,5,18,12
Sun 1 Mar 2020 18:00,2,1,1,68,34,34,21,7,14,36,18
Sun 1 Mar 2020 19:00,4,1,3,63,30,33,19,11,8,33,11
Sun 1 Mar 2020 20:00,1,1,0,40,20,20,20,10,10,16,8
Sun 1 Mar 2020 21:00,0,0,0,49,31,18,19,8,11,14,6
Sun 1 Mar 2020 22:00,2,1,1,33,23,10,13,5,8,21,9
Sun 1 Mar 2020 23:00,0,0,0,17,14,3,5,1,4,12,4
Mon 2 Mar 2020 00:00,1,0,1,13,10,3,5,1,4,8,1
Mon 2 Mar 2020 01:00,0,0,0,3,1,2,2,2,0,3,1
Mon 2 Mar 2020 02:00,0,0,0,5,5,0,0,0,0,3,0
Mon 2 Mar 2020 03:00,0,0,0,6,3,3,4,4,0,3,1
Mon 2 Mar 2020 04:00,0,0,0,9,3,6,5,4,1,3,3
Mon 2 Mar 2020 05:00,1,0,1,28,5,23,21,20,1,4,18
Mon 2 Mar 2020 06:00,4,3,1,143,15,128,127,123,4,16,71
Mon 2 Mar 2020 07:00,12,12,0,415,54,361,169,154,15,28,127
Mon 2 Mar 2020 08:00,36,31,5,876,81,795,327,310,17,43,344
Mon 2 Mar 2020 09:00,18,18,0,378,49,329,158,142,16,23,238
Mon 2 Mar 2020 10:00,1,0,1,82,16,66,44,38,6,12,61
Mon 2 Mar 2020 11:00,4,2,2,67,20,47,27,21,6,19,25
Mon 2 Mar 2020 12:00,5,3,2,83,29,54,47,33,14,37,31
Mon 2 Mar 2020 13:00,8,5,3,88,43,45,58,39,19,57,43
Mon 2 Mar 2020 14:00,5,5,0,92,43,49,28,17,11,51,23
Mon 2 Mar 2020 15:00,8,3,5,90,51,39,34,13,21,61,20
Mon 2 Mar 2020 16:00,7,3,4,237,166,71,76,39,37,158,40
Mon 2 Mar 2020 17:00,12,3,9,578,458,120,151,65,86,425,74
Mon 2 Mar 2020 18:00,4,3,1,487,373,114,129,41,88,369,51
Mon 2 Mar 2020 19:00,6,3,3,207,139,68,86,28,58,139,9
Mon 2 Mar 2020 20:00,2,2,0,104,77,27,33,14,19,92,13
Mon 2 Mar 2020 21:00,3,2,1,92,62,30,30,12,18,59,9
Mon 2 Mar 2020 22:00,0,0,0,49,30,19,21,5,16,44,19
Mon 2 Mar 2020 23:00,1,0,1,27,25,2,12,3,9,13,6
Tue 3 Mar 2020 00:00,1,1,0,8,8,0,5,2,3,10,1
Tue 3 Mar 2020 01:00,0,0,0,4,2,2,0,0,0,1,0
Tue 3 Mar 2020 02:00,2,0,2,6,6,0,0,0,0,5,0
Tue 3 Mar 2020 03:00,0,0,0,2,1,1,4,3,1,2,1
Tue 3 Mar 2020 04:00,0,0,0,5,1,4,5,5,0,1,7
Tue 3 Mar 2020 05:00,1,0,1,32,6,26,22,20,2,3,23
Tue 3 Mar 2020 06:00,6,5,1,141,16,125,120,117,3,12,57
Tue 3 Mar 2020 07:00,16,15,1,443,71,372,201,180,21,43,194
Tue 3 Mar 2020 08:00,36,33,3,1001,113,888,334,306,28,49,336
Tue 3 Mar 2020 09:00,15,15,0,357,38,319,165,145,20,26,218
Tue 3 Mar 2020 10:00,5,2,3,106,19,87,34,29,5,14,56
Tue 3 Mar 2020 11:00,7,4,3,69,25,44,37,27,10,15,34
Tue 3 Mar 2020 12:00,4,2,2,100,28,72,58,44,14,38,35
Tue 3 Mar 2020 13:00,6,3,3,123,61,62,46,31,15,48,51
Tue 3 Mar 2020 14:00,6,2,4,126,57,69,46,32,14,34,29
Tue 3 Mar 2020 15:00,4,3,1,129,68,61,41,17,24,61,46
Tue 3 Mar 2020 16:00,20,12,8,239,159,80,94,39,55,192,50
Tue 3 Mar 2020 17:00,16,8,8,604,474,130,153,53,100,401,73
Tue 3 Mar 2020 18:00,10,4,6,504,379,125,139,40,99,331,50
Tue 3 Mar 2020 19:00,7,5,2,210,144,66,77,34,43,157,21
Tue 3 Mar 2020 20:00,8,6,2,143,95,48,45,21,24,85,7
Tue 3 Mar 2020 21:00,3,2,1,88,66,22,35,13,22,64,6
Tue 3 Mar 2020 22:00,1,0,1,68,43,25,17,8,9,43,4
Tue 3 Mar 2020 23:00,1,1,0,37,31,6,19,3,16,37,6
Wed 4 Mar 2020 00:00,2,2,0,14,8,6,4,3,1,13,5
Wed 4 Mar 2020 01:00,1,0,1,5,5,0,1,0,1,9,0
Wed 4 Mar 2020 02:00,0,0,0,9,8,1,1,1,0,3,0
Wed 4 Mar 2020 03:00,0,0,0,4,2,2,2,2,0,4,0
Wed 4 Mar 2020 04:00,1,0,1,6,1,5,4,4,0,1,9
Wed 4 Mar 2020 05:00,3,0,3,37,8,29,25,23,2,2,23
Wed 4 Mar 2020 06:00,0,0,0,164,26,138,119,113,6,19,69
Wed 4 Mar 2020 07:00,19,16,3,414,69,345,194,176,18,35,195
Wed 4 Mar 2020 08:00,45,42,3,967,90,877,326,303,23,62,395
Wed 4 Mar 2020 09:00,16,13,3,390,56,334,162,143,19,21,156
Wed 4 Mar 2020 10:00,6,5,1,105,27,78,43,40,3,14,42
Wed 4 Mar 2020 11:00,7,5,2,80,23,57,27,19,8,14,45
Wed 4 Mar 2020 12:00,7,6,1,126,47,79,52,29,23,50,45
Wed 4 Mar 2020 13:00,7,4,3,125,49,76,56,38,18,58,51
Wed 4 Mar 2020 14:00,5,3,2,108,49,59,45,24,21,57,31
Wed 4 Mar 2020 15:00,1,0,1,104,53,51,40,21,19,72,31
Wed 4 Mar 2020 16:00,18,8,10,248,162,86,94,48,46,198,49
Wed 4 Mar 2020 17:00,12,6,6,574,436,138,164,62,102,429,101
Wed 4 Mar 2020 18:00,10,6,4,514,398,116,137,52,85,320,39
Wed 4 Mar 2020 19:00,4,0,4,205,139,66,60,30,30,139,17
Wed 4 Mar 2020 20:00,4,3,1,151,92,59,47,17,30,76,9
Wed 4 Mar 2020 21:00,2,2,0,90,66,24,36,7,29,83,13
Wed 4 Mar 2020 22:00,5,4,1,54,38,16,25,8,17,41,10
Wed 4 Mar 2020 23:00,2,1,1,46,39,7,14,3,11,37,9
Thu 5 Mar 2020 00:00,1,0,1,15,10,5,2,0,2,8,2
Thu 5 Mar 2020 01:00,0,0,0,4,2,2,1,0,1,10,0
Thu 5 Mar 2020 02:00,0,0,0,5,4,1,0,0,0,3,0
Thu 5 Mar 2020 03:00,2,0,2,5,2,3,2,2,0,3,1
Thu 5 Mar 2020 04:00,0,0,0,10,4,6,3,3,0,3,5
Thu 5 Mar 2020 05:00,1,0,1,35,4,31,24,22,2,2,22
Thu 5 Mar 2020 06:00,3,3,0,121,12,109,139,132,7,20,70
Thu 5 Mar 2020 07:00,14,13,1,423,71,352,187,170,17,35,232
Thu 5 Mar 2020 08:00,38,35,3,886,76,810,326,305,21,51,355
Thu 5 Mar 2020 09:00,20,16,4,393,45,348,176,158,18,25,247
Thu 5 Mar 2020 10:00,2,1,1,118,28,90,46,42,4,17,85
Thu 5 Mar 2020 11:00,3,3,0,80,22,58,41,30,11,25,44
Thu 5 Mar 2020 12:00,7,4,3,118,44,74,44,23,21,49,55
Thu 5 Mar 2020 13:00,4,1,3,107,49,58,46,34,12,62,45
Thu 5 Mar 2020 14:00,2,2,0,107,46,61,49,32,17,71,34
Thu 5 Mar 2020 15:00,7,4,3,136,71,65,39,15,24,50,35
Thu 5 Mar 2020 16:00,16,8,8,243,172,71,83,44,39,196,62
Thu 5 Mar 2020 17:00,15,7,8,514,404,110,166,65,101,402,87
Thu 5 Mar 2020 18:00,11,2,9,468,373,95,127,43,84,317,66
Thu 5 Mar 2020 19:00,8,3,5,214,148,66,68,25,43,142,37
Thu 5 Mar 2020 20:00,3,2,1,135,88,47,43,18,25,110,16
Thu 5 Mar 2020 21:00,2,1,1,119,81,38,31,17,14,83,8
Thu 5 Mar 2020 22:00,1,1,0,83,53,30,36,14,22,48,5
Thu 5 Mar 2020 23:00,0,0,0,48,33,15,20,3,17,33,4
Fri 6 Mar 2020 00:00,1,1,0,18,14,4,3,1,2,21,6
Fri 6 Mar 2020 01:00,1,1,0,8,6,2,1,1,0,8,1
Fri 6 Mar 2020 02:00,3,0,3,5,5,0,0,0,0,2,0
Fri 6 Mar 2020 03:00,0,0,0,4,3,1,4,3,1,5,4
Fri 6 Mar 2020 04:00,1,1,0,10,2,8,4,4,0,5,6
Fri 6 Mar 2020 05:00,0,0,0,36,8,28,18,17,1,5,27
Fri 6 Mar 2020 06:00,3,3,0,126,14,112,118,116,2,11,88
Fri 6 Mar 2020 07:00,13,13,0,354,48,306,150,142,8,27,134
Fri 6 Mar 2020 08:00,32,30,2,725,76,649,292,264,28,51,301
Fri 6 Mar 2020 09:00,18,13,5,330,35,295,171,156,15,32,213
Fri 6 Mar 2020 10:00,5,4,1,86,25,61,36,31,5,15,53
Fri 6 Mar 2020 11:00,2,2,0,68,16,52,46,32,14,12,45
Fri 6 Mar 2020 12:00,6,2,4,114,29,85,54,37,17,56,50
Fri 6 Mar 2020 13:00,5,4,1,135,59,76,48,35,13,79,46
Fri 6 Mar 2020 14:00,8,6,2,119,68,51,51,31,20,65,28
Fri 6 Mar 2020 15:00,6,5,1,143,83,60,62,28,34,85,31
Fri 6 Mar 2020 16:00,6,4,2,271,174,97,77,38,39,171,53
Fri 6 Mar 2020 17:00,14,4,10,467,348,119,146,55,91,344,85
Fri 6 Mar 2020 18:00,4,0,4,307,227,80,107,36,71,211,39
Fri 6 Mar 2020 19:00,5,2,3,181,122,59,54,27,27,102,15
Fri 6 Mar 2020 20:00,5,2,3,89,59,30,38,17,21,72,17
Fri 6 Mar 2020 21:00,5,3,2,82,51,31,30,15,15,51,16
Fri 6 Mar 2020 22:00,3,1,2,65,43,22,27,14,13,41,13
Fri 6 Mar 2020 23:00,3,2,1,52,31,21,25,6,19,35,8
Sat 7 Mar 2020 00:00,0,0,0,19,14,5,10,5,5,25,6
Sat 7 Mar 2020 01:00,1,0,1,9,5,4,5,4,1,11,4
Sat 7 Mar 2020 02:00,1,0,1,8,5,3,3,2,1,7,3
Sat 7 Mar 2020 03:00,1,0,1,16,12,4,0,0,0,7,2
Sat 7 Mar 2020 04:00,0,0,0,10,4,6,1,1,0,7,5
Sat 7 Mar 2020 05:00,1,1,0,14,1,13,9,7,2,4,13
Sat 7 Mar 2020 06:00,3,1,2,42,14,28,26,24,2,8,19
Sat 7 Mar 2020 07:00,0,0,0,57,18,39,39,39,0,12,26
Sat 7 Mar 2020 08:00,3,3,0,78,21,57,20,17,3,13,26
Sat 7 Mar 2020 09:00,2,1,1,91,26,65,36,33,3,15,39
Sat 7 Mar 2020 10:00,4,4,0,66,16,50,32,20,12,15,29
Sat 7 Mar 2020 11:00,2,1,1,73,19,54,36,24,12,35,30
Sat 7 Mar 2020 12:00,9,7,2,123,31,92,32,17,15,32,41
Sat 7 Mar 2020 13:00,5,1,4,95,47,48,46,27,19,44,33
Sat 7 Mar 2020 14:00,4,2,2,100,43,57,26,17,9,37,29
Sat 7 Mar 2020 15:00,2,2,0,77,29,48,24,13,11,37,36
Sat 7 Mar 2020 16:00,4,3,1,76,31,45,23,16,7,38,19
Sat 7 Mar 2020 17:00,10,6,4,84,35,49,45,34,11,35,15
Sat 7 Mar 2020 18:00,3,1,2,78,38,40,25,15,10,39,30
Sat 7 Mar 2020 19:00,2,1,1,60,33,27,27,14,13,32,11
Sat 7 Mar 2020 20:00,1,0,1,55,32,23,36,20,16,22,12
Sat 7 Mar 2020 21:00,2,1,1,38,15,23,26,8,18,17,11
Sat 7 Mar 2020 22:00,2,1,1,34,19,15,18,9,9,27,12
Sat 7 Mar 2020 23:00,1,0,1,19,13,6,13,1,12,19,7
Sun 8 Mar 2020 00:00,2,1,1,22,18,4,5,2,3,15,2
Sun 8 Mar 2020 01:00,2,2,0,17,10,7,4,2,2,11,1
Sun 8 Mar 2020 02:00,2,0,2,12,8,4,1,0,1,6,1
Sun 8 Mar 2020 03:00,0,0,0,10,5,5,0,0,0,2,1
Sun 8 Mar 2020 04:00,1,0,1,10,2,8,1,1,0,4,0
Sun 8 Mar 2020 05:00,1,1,0,10,3,7,5,5,0,5,7
Sun 8 Mar 2020 06:00,0,0,0,25,4,21,15,14,1,12,15
Sun 8 Mar 2020 07:00,1,0,1,32,9,23,22,21,1,9,17
Sun 8 Mar 2020 08:00,0,0,0,47,26,21,24,21,3,8,30
Sun 8 Mar 2020 09:00,2,0,2,60,23,37,24,17,7,21,38
Sun 8 Mar 2020 10:00,1,0,1,67,21,46,23,15,8,21,26
Sun 8 Mar 2020 11:00,1,0,1,55,16,39,20,14,6,33,39
Sun 8 Mar 2020 12:00,4,4,0,92,25,67,33,23,10,35,26
Sun 8 Mar 2020 13:00,2,1,1,107,56,51,30,19,11,28,33
Sun 8 Mar 2020 14:00,4,2,2,66,27,39,29,24,5,33,33
Sun 8 Mar 2020 15:00,7,4,3,57,28,29,29,18,11,23,41
Sun 8 Mar 2020 16:00,2,0,2,62,34,28,27,14,13,32,21
Sun 8 Mar 2020 17:00,2,1,1,69,32,37,28,18,10,29,27
Sun 8 Mar 2020 18:00,3,3,0,68,32,36,29,20,9,35,23
Sun 8 Mar 2020 19:00,3,1,2,75,38,37,30,17,13,31,12
Sun 8 Mar 2020 20:00,5,3,2,43,23,20,25,13,12,20,9
Sun 8 Mar 2020 21:00,3,0,3,46,24,22,10,3,7,14,2
Sun 8 Mar 2020 22:00,2,0,2,24,16,8,18,10,8,27,5
Sun 8 Mar 2020 23:00,0,0,0,21,13,8,10,3,7,18,8
Mon 9 Mar 2020 00:00,0,0,0,12,10,2,0,0,0,7,1
Mon 9 Mar 2020 01:00,1,1,0,4,2,2,0,0,0,2,4
Mon 9 Mar 2020 02:00,0,0,0,2,2,0,1,0,1,1,0
Mon 9 Mar 2020 03:00,0,0,0,2,0,2,4,3,1,2,1
Mon 9 Mar 2020 04:00,1,0,1,5,2,3,4,4,0,2,7
Mon 9 Mar 2020 05:00,1,0,1,30,4,26,12,11,1,5,22
Mon 9 Mar 2020 06:00,3,3,0,123,16,107,114,109,5,11,67
Mon 9 Mar 2020 07:00,12,10,2,359,42,317,185,168,17,31,196
Mon 9 Mar 2020 08:00,45,41,4,877,81,796,315,289,26,63,497
Mon 9 Mar 2020 09:00,23,21,2,354,41,313,151,137,14,27,197
Mon 9 Mar 2020 10:00,7,2,5,74,16,58,34,32,2,10,48
Mon 9 Mar 2020 11:00,3,2,1,48,16,32,27,22,5,9,34
Mon 9 Mar 2020 12:00,5,3,2,74,27,47,32,24,8,36,20
Mon 9 Mar 2020 13:00,4,2,2,81,35,46,40,24,16,45,23
Mon 9 Mar 2020 14:00,5,2,3,57,26,31,37,23,14,43,21
Mon 9 Mar 2020 15:00,0,0,0,92,60,32,39,17,22,37,22
Mon 9 Mar 2020 16:00,4,2,2,226,142,84,62,27,35,147,38
Mon 9 Mar 2020 17:00,13,2,11,483,408,75,166,65,101,411,69
Mon 9 Mar 2020 18:00,12,3,9,422,339,83,136,34,102,289,39
Mon 9 Mar 2020 19:00,7,5,2,191,142,49,58,25,33,141,15
Mon 9 Mar 2020 20:00,3,3,0,105,72,33,45,21,24,66,15
Mon 9 Mar 2020 21:00,5,4,1,67,48,19,34,17,17,42,7
Mon 9 Mar 2020 22:00,2,0,2,44,32,12,32,20,12,28,6
Mon 9 Mar 2020 23:00,0,0,0,24,20,4,13,1,12,17,3
Tue 10 Mar 2020 00:00,1,1,0,15,13,2,5,2,3,9,0
Tue 10 Mar 2020 01:00,0,0,0,3,3,0,1,1,0,0,0
Tue 10 Mar 2020 02:00,1,0,1,2,2,0,0,0,0,2,1
Tue 10 Mar 2020 03:00,1,0,1,1,0,1,2,2,0,2,2
Tue 10 Mar 2020 04:00,0,0,0,5,1,4,5,5,0,2,4
Tue 10 Mar 2020 05:00,1,0,1,30,6,24,19,17,2,4,14
Tue 10 Mar 2020 06:00,5,4,1,150,35,115,109,102,7,9,51
Tue 10 Mar 2020 07:00,19,16,3,412,54,358,171,158,13,31,152
Tue 10 Mar 2020 08:00,36,30,6,849,89,760,333,317,16,53,451
Tue 10 Mar 2020 09:00,10,10,0,325,34,291,170,154,16,22,195
Tue 10 Mar 2020 10:00,1,1,0,79,22,57,37,30,7,8,66
Tue 10 Mar 2020 11:00,4,3,1,84,23,61,28,23,5,5,30
Tue 10 Mar 2020 12:00,1,1,0,115,41,74,48,36,12,36,31
Tue 10 Mar 2020 13:00,6,2,4,111,48,63,44,35,9,39,38
Tue 10 Mar 2020 14:00,7,5,2,83,48,35,35,26,9,53,20
Tue 10 Mar 2020 15:00,8,5,3,113,58,55,49,21,28,72,35
Tue 10 Mar 2020 16:00,14,7,7,194,130,64,88,47,41,158,43
Tue 10 Mar 2020 17:00,17,5,12,529,399,130,180,61,119,331,65
Tue 10 Mar 2020 18:00,8,4,4,463,358,105,153,43,110,359,56
Tue 10 Mar 2020 19:00,7,1,6,234,167,67,71,30,41,148,24
Tue 10 Mar 2020 20:00,5,3,2,160,105,55,55,15,40,87,2
Tue 10 Mar 2020 21:00,5,1,4,92,67,25,18,8,10,52,9
Tue 10 Mar 2020 22:00,1,1,0,49,31,18,29,15,14,45,8
Tue 10 Mar 2020 23:00,2,1,1,37,23,14,16,4,12,14,4
Wed 11 Mar 2020 00:00,2,2,0,13,9,4,6,3,3,8,6
Wed 11 Mar 2020 01:00,0,0,0,6,4,2,1,1,0,1,0
Wed 11 Mar 2020 02:00,0,0,0,6,3,3,1,0,1,5,1
Wed 11 Mar 2020 03:00,2,0,2,1,0,1,2,2,0,4,2
Wed 11 Mar 2020 04:00,0,0,0,10,1,9,7,7,0,4,10
Wed 11 Mar 2020 05:00,1,0,1,33,5,28,19,16,3,8,16
Wed 11 Mar 2020 06:00,4,3,1,125,20,105,122,118,4,15,72
Wed 11 Mar 2020 07:00,16,13,3,402,41,361,184,163,21,32,226
Wed 11 Mar 2020 08:00,38,31,7,889,88,801,301,274,27,55,304
Wed 11 Mar 2020 09:00,15,12,3,357,39,318,149,137,12,30,200
Wed 11 Mar 2020 10:00,2,2,0,63,10,53,34,30,4,12,52
Wed 11 Mar 2020 11:00,2,1,1,81,25,56,29,24,5,15,34
Wed 11 Mar 2020 12:00,3,1,2,106,46,60,45,28,17,33,56
Wed 11 Mar 2020 13:00,6,3,3,95,48,47,47,32,15,37,47
Wed 11 Mar 2020 14:00,4,2,2,106,49,57,42,30,12,51,30
Wed 11 Mar 2020 15:00,4,4,0,111,61,50,39,13,26,67,28
Wed 11 Mar 2020 16:00,7,4,3,195,124,71,71,33,38,140,40
Wed 11 Mar 2020 17:00,10,4,6,473,386,87,145,62,83,361,56
Wed 11 Mar 2020 18:00,14,6,8,418,345,73,112,33,79,323,39
Wed 11 Mar 2020 19:00,5,3,2,160,124,36,68,29,39,140,20
Wed 11 Mar 2020 20:00,3,2,1,113,79,34,34,16,18,50,12
Wed 11 Mar 2020 21:00,2,1,1,58,44,14,23,6,17,44,8
Wed 11 Mar 2020 22:00,1,0,1,43,32,11,34,5,29,38,10
Wed 11 Mar 2020 23:00,0,0,0,25,19,6,7,2,5,19,5
Thu 12 Mar 2020 00:00,0,0,0,14,11,3,8,3,5,11,5
Thu 12 Mar 2020 01:00,0,0,0,5,4,1,0,0,0,3,0
Thu 12 Mar 2020 02:00,0,0,0,1,1,0,1,1,0,1,1
Thu 12 Mar 2020 03:00,1,0,1,4,3,1,2,2,0,4,2
Thu 12 Mar 2020 04:00,0,0,0,5,0,5,5,5,0,2,7
Thu 12 Mar 2020 05:00,0,0,0,24,5,19,14,13,1,3,16
Thu 12 Mar 2020 06:00,4,3,1,115,16,99,110,106,4,12,60
Thu 12 Mar 2020 07:00,16,14,2,346,47,299,127,119,8,28,161
Thu 12 Mar 2020 08:00,38,32,6,723,57,666,249,227,22,57,293
Thu 12 Mar 2020 09:00,17,17,0,286,22,264,139,119,20,26,196
Thu 12 Mar 2020 10:00,4,1,3,70,24,46,34,29,5,17,55
Thu 12 Mar 2020 11:00,1,0,1,58,15,43,27,20,7,15,24
Thu 12 Mar 2020 12:00,4,3,1,90,36,54,41,29,12,39,29
Thu 12 Mar 2020 13:00,7,4,3,94,39,55,37,28,9,53,34
Thu 12 Mar 2020 14:00,4,2,2,93,49,44,32,20,12,52,25
Thu 12 Mar 2020 15:00,7,4,3,120,66,54,46,18,28,57,27
Thu 12 Mar 2020 16:00,4,3,1,210,135,75,77,33,44,143,31
Thu 12 Mar 2020 17:00,12,3,9,409,319,90,118,48,70,307,51
Thu 12 Mar 2020 18:00,6,5,1,391,305,86,93,31,62,233,41
Thu 12 Mar 2020 19:00,6,4,2,168,125,43,55,26,29,112,20
Thu 12 Mar 2020 20:00,2,2,0,105,65,40,46,21,25,63,14
Thu 12 Mar 2020 21:00,1,0,1,46,32,14,25,7,18,41,6
Thu 12 Mar 2020 22:00,1,1,0,36,26,10,12,4,8,31,12
Thu 12 Mar 2020 23:00,4,2,2,22,15,7,5,2,3,16,6
Fri 13 Mar 2020 00:00,3,0,3,11,10,1,3,1,2,16,4
Fri 13 Mar 2020 01:00,0,0,0,9,8,1,1,1,0,7,0
Fri 13 Mar 2020 02:00,0,0,0,7,3,4,1,0,1,2,1
Fri 13 Mar 2020 03:00,1,1,0,4,3,1,1,1,0,2,2
Fri 13 Mar 2020 04:00,1,0,1,5,2,3,5,5,0,2,5
Fri 13 Mar 2020 05:00,1,0,1,27,4,23,15,14,1,4,13
Fri 13 Mar 2020 06:00,6,5,1,103,11,92,92,90,2,10,73
Fri 13 Mar 2020 07:00,7,5,2,221,41,180,79,72,7,26,124
Fri 13 Mar 2020 08:00,18,16,2,394,42,352,139,123,16,37,229
Fri 13 Mar 2020 09:00,7,4,3,176,30,146,102,89,13,27,122
Fri 13 Mar 2020 10:00,6,5,1,78,16,62,33,26,7,29,45
Fri 13 Mar 2020 11:00,6,5,1,80,23,57,32,23,9,21,34
Fri 13 Mar 2020 12:00,6,2,4,100,42,58,37,24,13,31,44
Fri 13 Mar 2020 13:00,6,5,1,125,43,82,43,24,19,66,45
Fri 13 Mar 2020 14:00,10,7,3,112,59,53,48,28,20,48,42
Fri 13 Mar 2020 15:00,3,2,1,128,77,51,33,14,19,69,28
Fri 13 Mar 2020 16:00,10,6,4,180,121,59,65,41,24,118,44
Fri 13 Mar 2020 17:00,8,3,5,250,182,68,99,43,56,190,53
Fri 13 Mar 2020 18:00,4,4,0,194,145,49,77,30,47,134,41
Fri 13 Mar 2020 19:00,3,2,1,123,70,53,38,18,20,60,22
Fri 13 Mar 2020 20:00,1,1,0,76,47,29,21,12,9,44,10
Fri 13 Mar 2020 21:00,3,2,1,49,35,14,19,6,13,24,6
Fri 13 Mar 2020 22:00,2,2,0,33,26,7,13,5,8,27,0
Fri 13 Mar 2020 23:00,2,1,1,33,24,9,7,2,5,20,4
Sat 14 Mar 2020 00:00,0,0,0,17,11,6,3,0,3,6,6
Sat 14 Mar 2020 01:00,1,0,1,16,12,4,4,1,3,8,2
Sat 14 Mar 2020 02:00,0,0,0,14,8,6,1,1,0,6,1
Sat 14 Mar 2020 03:00,0,0,0,8,5,3,0,0,0,5,2
Sat 14 Mar 2020 04:00,1,1,0,7,0,7,1,1,0,4,2
Sat 14 Mar 2020 05:00,0,0,0,18,5,13,7,7,0,2,5
Sat 14 Mar 2020 06:00,1,0,1,27,3,24,21,20,1,5,18
Sat 14 Mar 2020 07:00,0,0,0,42,8,34,40,38,2,6,25
Sat 14 Mar 2020 08:00,2,1,1,49,13,36,20,18,2,13,23
Sat 14 Mar 2020 09:00,4,3,1,62,19,43,24,23,1,18,25
Sat 14 Mar 2020 10:00,1,0,1,56,23,33,31,25,6,22,16
Sat 14 Mar 2020 11:00,2,0,2,65,19,46,30,15,15,36,26
Sat 14 Mar 2020 12:00,4,4,0,64,27,37,26,17,9,27,19
Sat 14 Mar 2020 13:00,7,4,3,74,36,38,29,19,10,22,11
Sat 14 Mar 2020 14:00,4,1,3,54,28,26,26,13,13,39,25
Sat 14 Mar 2020 15:00,1,1,0,64,37,27,24,15,9,31,27
Sat 14 Mar 2020 16:00,8,4,4,65,24,41,24,16,8,31,33
Sat 14 Mar 2020 17:00,5,4,1,67,34,33,33,21,12,36,25
Sat 14 Mar 2020 18:00,1,1,0,71,36,35,20,10,10,32,15
Sat 14 Mar 2020 19:00,2,0,2,58,27,31,27,20,7,29,12
Sat 14 Mar 2020 20:00,4,3,1,38,18,20,19,17,2,18,1
Sat 14 Mar 2020 21:00,0,0,0,27,20,7,11,7,4,15,1
Sat 14 Mar 2020 22:00,2,2,0,26,20,6,12,7,5,24,7
Sat 14 Mar 2020 23:00,2,2,0,28,19,9,10,1,9,13,4
Sun 15 Mar 2020 00:00,1,0,1,9,5,4,5,0,5,11,3
Sun 15 Mar 2020 01:00,0,0,0,12,11,1,2,2,0,3,1
Sun 15 Mar 2020 02:00,1,0,1,4,2,2,0,0,0,3,0
Sun 15 Mar 2020 03:00,1,1,0,5,3,2,0,0,0,3,0
Sun 15 Mar 2020 04:00,0,0,0,9,4,5,0,0,0,0,0
Sun 15 Mar 2020 05:00,1,0,1,10,1,9,5,5,0,0,8
Sun 15 Mar 2020 06:00,0,0,0,17,2,15,14,12,2,8,11
Sun 15 Mar 2020 07:00,1,1,0,23,4,19,20,20,0,5,24
Sun 15 Mar 2020 08:00,1,0,1,26,4,22,19,18,1,9,17
Sun 15 Mar 2020 09:00,1,1,0,37,7,30,9,9,0,8,11
Sun 15 Mar 2020 10:00,5,4,1,56,17,39,21,13,8,23,14
Sun 15 Mar 2020 11:00,6,5,1,67,30,37,24,16,8,29,24
Sun 15 Mar 2020 12:00,3,1,2,70,34,36,22,11,11,40,34
Sun 15 Mar 2020 13:00,6,5,1,83,45,38,26,18,8,43,39
Sun 15 Mar 2020 14:00,7,6,1,81,34,47,35,20,15,50,24
Sun 15 Mar 2020 15:00,7,6,1,70,25,45,36,18,18,42,27
Sun 15 Mar 2020 16:00,4,2,2,68,33,35,48,30,18,38,29
Sun 15 Mar 2020 17:00,6,4,2,95,46,49,37,20,17,47,33
Sun 15 Mar 2020 18:00,1,0,1,58,34,24,28,21,7,29,17
Sun 15 Mar 2020 19:00,2,2,0,45,26,19,18,10,8,13,8
Sun 15 Mar 2020 20:00,1,1,0,28,16,12,13,6,7,17,7
Sun 15 Mar 2020 21:00,2,0,2,31,18,13,9,6,3,18,6
Sun 15 Mar 2020 22:00,1,1,0,31,22,9,11,7,4,17,3
Sun 15 Mar 2020 23:00,1,0,1,13,8,5,4,4,0,10,4
Mon 16 Mar 2020 00:00,1,0,1,5,4,1,0,0,0,4,1
Mon 16 Mar 2020 01:00,0,0,0,6,4,2,0,0,0,1,1
Mon 16 Mar 2020 02:00,0,0,0,3,2,1,2,2,0,1,1
Mon 16 Mar 2020 03:00,0,0,0,4,0,4,4,3,1,0,1
Mon 16 Mar 2020 04:00,0,0,0,10,2,8,0,0,0,2,1
Mon 16 Mar 2020 05:00,0,0,0,16,2,14,13,12,1,1,13
Mon 16 Mar 2020 06:00,1,1,0,70,14,56,57,57,0,9,62
Mon 16 Mar 2020 07:00,7,5,2,166,35,131,70,62,8,24,113
Mon 16 Mar 2020 08:00,5,3,2,256,42,214,93,79,14,33,123
Mon 16 Mar 2020 09:00,9,7,2,116,25,91,54,44,10,18,84
Mon 16 Mar 2020 10:00,2,0,2,72,19,53,13,10,3,13,38
Mon 16 Mar 2020 11:00,6,5,1,64,23,41,31,24,7,36,34
Mon 16 Mar 2020 12:00,2,1,1,96,37,59,29,21,8,41,35
Mon 16 Mar 2020 13:00,7,3,4,85,44,41,29,21,8,46,20
Mon 16 Mar 2020 14:00,3,1,2,94,55,39,36,23,13,48,28
Mon 16 Mar 2020 15:00,4,1,3,90,66,24,34,13,21,56,31
Mon 16 Mar 2020 16:00,8,4,4,129,80,49,51,29,22,99,44
Mon 16 Mar 2020 17:00,5,2,3,171,111,60,61,25,36,153,47
Mon 16 Mar 2020 18:00,5,3,2,134,93,41,59,25,34,126,21
Mon 16 Mar 2020 19:00,5,3,2,85,57,28,26,12,14,48,10
Mon 16 Mar 2020 20:00,5,3,2,53,28,25,19,11,8,14,3
Mon 16 Mar 2020 21:00,6,2,4,25,19,6,11,7,4,9,1
Mon 16 Mar 2020 22:00,5,1,4,14,9,5,9,5,4,14,5
Mon 16 Mar 2020 23:00,0,0,0,10,7,3,5,1,4,12,3
Tue 17 Mar 2020 00:00,0,0,0,4,1,3,2,2,0,2,0
Tue 17 Mar 2020 01:00,0,0,0,2,1,1,0,0,0,0,1
Tue 17 Mar 2020 02:00,0,0,0,3,2,1,0,0,0,0,0
Tue 17 Mar 2020 03:00,0,0,0,2,1,1,0,0,0,1,1
Tue 17 Mar 2020 04:00,0,0,0,3,0,3,1,1,0,0,2
Tue 17 Mar 2020 05:00,0,0,0,16,1,15,2,1,1,2,3
Tue 17 Mar 2020 06:00,1,1,0,30,6,24,13,12,1,8,26
Tue 17 Mar 2020 07:00,4,4,0,27,5,22,21,16,5,8,21
Tue 17 Mar 2020 08:00,1,1,0,52,11,41,19,15,4,12,22
Tue 17 Mar 2020 09:00,1,1,0,37,17,20,16,11,5,20,23
Tue 17 Mar 2020 10:00,2,2,0,46,12,34,22,11,11,18,31
Tue 17 Mar 2020 11:00,6,3,3,58,25,33,21,15,6,44,26
Tue 17 Mar 2020 12:00,11,7,4,88,32,56,31,20,11,40,39
Tue 17 Mar 2020 13:00,3,3,0,69,38,31,26,20,6,39,36
Tue 17 Mar 2020 14:00,7,3,4,102,50,52,40,22,18,43,35
Tue 17 Mar 2020 15:00,6,2,4,103,47,56,24,10,14,42,30
Tue 17 Mar 2020 16:00,6,5,1,90,40,50,32,26,6,35,23
Tue 17 Mar 2020 17:00,8,5,3,75,41,34,34,14,20,37,31
Tue 17 Mar 2020 18:00,5,2,3,46,21,25,24,20,4,29,30
Tue 17 Mar 2020 19:00,4,2,2,32,18,14,15,9,6,17,12
Tue 17 Mar 2020 20:00,2,0,2,32,18,14,12,7,5,9,3
Tue 17 Mar 2020 21:00,1,1,0,16,11,5,13,8,5,12,8
Tue 17 Mar 2020 22:00,4,2,2,13,9,4,8,5,3,13,4
Tue 17 Mar 2020 23:00,3,3,0,14,7,7,11,2,9,7,3
Wed 18 Mar 2020 00:00,0,0,0,3,1,2,1,1,0,3,2
Wed 18 Mar 2020 01:00,0,0,0,4,3,1,0,0,0,2,4
Wed 18 Mar 2020 02:00,1,0,1,2,0,2,0,0,0,4,1
Wed 18 Mar 2020 03:00,0,0,0,3,2,1,2,2,0,1,1
Wed 18 Mar 2020 04:00,0,0,0,6,0,6,3,3,0,0,2
Wed 18 Mar 2020 05:00,1,0,1,20,6,14,8,7,1,3,6
Wed 18 Mar 2020 06:00,6,4,2,77,8,69,69,65,4,14,61
Wed 18 Mar 2020 07:00,6,4,2,147,32,115,59,49,10,17,125
Wed 18 Mar 2020 08:00,5,4,1,258,43,215,104,89,15,26,173
Wed 18 Mar 2020 09:00,7,7,0,132,29,103,46,39,7,23,80
Wed 18 Mar 2020 10:00,4,2,2,53,17,36,29,23,6,23,43
Wed 18 Mar 2020 11:00,0,0,0,68,27,41,27,17,10,19,34
Wed 18 Mar 2020 12:00,2,1,1,65,26,39,32,20,12,35,35
Wed 18 Mar 2020 13:00,4,2,2,86,38,48,30,19,11,48,40
Wed 18 Mar 2020 14:00,4,2,2,73,36,37,30,20,10,41,41
Wed 18 Mar 2020 15:00,4,2,2,87,52,35,31,17,14,57,28
Wed 18 Mar 2020 16:00,4,3,1,127,69,58,41,20,21,107,38
Wed 18 Mar 2020 17:00,11,3,8,197,136,61,70,37,33,199,51
Wed 18 Mar 2020 18:00,7,5,2,178,122,56,52,20,32,131,20
Wed 18 Mar 2020 19:00,3,1,2,85,44,41,21,8,13,44,14
Wed 18 Mar 2020 20:00,6,4,2,47,28,19,20,11,9,31,5
Wed 18 Mar 2020 21:00,3,1,2,36,25,11,4,2,2,21,10
Wed 18 Mar 2020 22:00,3,1,2,26,21,5,8,2,6,23,7
Wed 18 Mar 2020 23:00,0,0,0,11,7,4,6,2,4,10,1
Thu 19 Mar 2020 00:00,0,0,0,5,4,1,2,2,0,1,2
Thu 19 Mar 2020 01:00,0,0,0,2,1,1,1,1,0,2,1
Thu 19 Mar 2020 02:00,0,0,0,1,1,0,1,1,0,2,0
Thu 19 Mar 2020 03:00,0,0,0,2,2,0,0,0,0,1,1
Thu 19 Mar 2020 04:00,1,0,1,2,0,2,4,4,0,0,1
Thu 19 Mar 2020 05:00,0,0,0,19,4,15,6,6,0,2,7
Thu 19 Mar 2020 06:00,1,1,0,80,12,68,61,59,2,10,62
Thu 19 Mar 2020 07:00,7,7,0,162,28,134,73,64,9,18,124
Thu 19 Mar 2020 08:00,8,7,1,202,47,155,100,89,11,28,183
Thu 19 Mar 2020 09:00,4,4,0,122,37,85,27,21,6,15,77
Thu 19 Mar 2020 10:00,6,6,0,64,19,45,19,15,4,22,42
Thu 19 Mar 2020 11:00,2,2,0,75,19,56,33,24,9,21,30
Thu 19 Mar 2020 12:00,1,0,1,100,51,49,34,20,14,37,34
Thu 19 Mar 2020 13:00,7,1,6,98,37,61,32,22,10,68,33
Thu 19 Mar 2020 14:00,8,4,4,84,33,51,28,16,12,38,42
Thu 19 Mar 2020 15:00,1,0,1,97,48,49,36,21,15,73,33
Thu 19 Mar 2020 16:00,5,2,3,184,115,69,41,15,26,107,40
Thu 19 Mar 2020 17:00,4,2,2,187,113,74,59,29,30,171,49
Thu 19 Mar 2020 18:00,4,1,3,166,112,54,64,29,35,122,33
Thu 19 Mar 2020 19:00,3,1,2,104,55,49,25,15,10,43,7
Thu 19 Mar 2020 20:00,2,1,1,72,44,28,25,9,16,28,3
Thu 19 Mar 2020 21:00,1,1,0,42,24,18,10,4,6,23,12
Thu 19 Mar 2020 22:00,1,0,1,18,12,6,11,7,4,15,4
Thu 19 Mar 2020 23:00,0,0,0,9,6,3,5,1,4,12,2
Fri 20 Mar 2020 00:00,1,1,0,10,8,2,1,0,1,3,2
Fri 20 Mar 2020 01:00,0,0,0,6,1,5,2,2,0,1,0
Fri 20 Mar 2020 02:00,0,0,0,0,0,0,0,0,0,1,0
Fri 20 Mar 2020 03:00,1,1,0,2,2,0,1,1,0,0,2
Fri 20 Mar 2020 04:00,0,0,0,5,1,4,3,3,0,1,0
Fri 20 Mar 2020 05:00,1,0,1,19,3,16,8,8,0,3,9
Fri 20 Mar 2020 06:00,3,2,1,71,15,56,60,58,2,12,60
Fri 20 Mar 2020 07:00,5,3,2,134,31,103,59,53,6,20,89
Fri 20 Mar 2020 08:00,7,5,2,201,47,154,84,73,11,21,103
Fri 20 Mar 2020 09:00,7,7,0,94,29,65,37,31,6,16,71
Fri 20 Mar 2020 10:00,4,3,1,59,20,39,23,20,3,18,36
Fri 20 Mar 2020 11:00,5,3,2,80,29,51,26,17,9,28,36
Fri 20 Mar 2020 12:00,7,3,4,81,34,47,33,19,14,32,28
Fri 20 Mar 2020 13:00,6,2,4,117,57,60,39,24,15,56,40
Fri 20 Mar 2020 14:00,4,2,2,96,46,50,42,22,20,67,42
Fri 20 Mar 2020 15:00,7,2,5,109,59,50,42,21,21,64,47
Fri 20 Mar 2020 16:00,12,9,3,142,89,53,52,30,22,99,39
Fri 20 Mar 2020 17:00,6,4,2,193,121,72,54,26,28,149,50
Fri 20 Mar 2020 18:00,7,2,5,128,66,62,58,28,30,118,30
Fri 20 Mar 2020 19:00,2,0,2,82,50,32,21,10,11,51,18
Fri 20 Mar 2020 20:00,2,0,2,69,43,26,27,15,12,26,9
Fri 20 Mar 2020 21:00,0,0,0,33,20,13,17,11,6,18,15
Fri 20 Mar 2020 22:00,0,0,0,30,23,7,6,3,3,12,3
Fri 20 Mar 2020 23:00,5,1,4,14,6,8,9,4,5,9,4
Sat 21 Mar 2020 00:00,1,1,0,8,4,4,2,1,1,4,1
Sat 21 Mar 2020 01:00,1,1,0,5,4,1,1,0,1,2,2
Sat 21 Mar 2020 02:00,1,0,1,4,1,3,0,0,0,1,0
Sat 21 Mar 2020 03:00,0,0,0,3,2,1,0,0,0,1,0
Sat 21 Mar 2020 04:00,0,0,0,6,2,4,1,1,0,1,1
Sat 21 Mar 2020 05:00,0,0,0,11,2,9,2,2,0,1,2
Sat 21 Mar 2020 06:00,0,0,0,25,5,20,7,6,1,9,10
Sat 21 Mar 2020 07:00,1,1,0,39,7,32,20,18,2,12,26
Sat 21 Mar 2020 08:00,4,3,1,36,13,23,25,16,9,15,23
Sat 21 Mar 2020 09:00,0,0,0,53,19,34,20,14,6,15,28
Sat 21 Mar 2020 10:00,4,3,1,49,20,29,20,12,8,38,28
Sat 21 Mar 2020 11:00,3,1,2,62,21,41,28,19,9,25,21
Sat 21 Mar 2020 12:00,2,0,2,59,27,32,40,20,20,34,37
Sat 21 Mar 2020 13:00,5,0,5,87,38,49,42,23,19,51,37
Sat 21 Mar 2020 14:00,12,8,4,85,39,46,40,23,17,37,41
Sat 21 Mar 2020 15:00,4,3,1,105,41,64,35,19,16,42,35
Sat 21 Mar 2020 16:00,10,4,6,87,40,47,39,17,22,55,36
Sat 21 Mar 2020 17:00,3,2,1,72,33,39,24,12,12,44,24
Sat 21 Mar 2020 18:00,3,2,1,67,29,38,28,22,6,42,25
Sat 21 Mar 2020 19:00,2,0,2,52,29,23,15,7,8,25,13
Sat 21 Mar 2020 20:00,0,0,0,45,24,21,15,9,6,16,6
Sat 21 Mar 2020 21:00,4,2,2,40,25,15,19,15,4,10,9
Sat 21 Mar 2020 22:00,0,0,0,25,17,8,8,4,4,18,7
Sat 21 Mar 2020 23:00,0,0,0,11,7,4,4,3,1,14,3
Sun 22 Mar 2020 00:00,1,0,1,5,3,2,4,3,1,3,7
Sun 22 Mar 2020 01:00,0,0,0,2,2,0,0,0,0,2,2
Sun 22 Mar 2020 02:00,0,0,0,2,1,1,0,0,0,2,2
Sun 22 Mar 2020 03:00,0,0,0,4,2,2,1,0,1,1,1
Sun 22 Mar 2020 04:00,0,0,0,4,2,2,0,0,0,0,0
Sun 22 Mar 2020 05:00,0,0,0,5,0,5,6,6,0,0,7
Sun 22 Mar 2020 06:00,0,0,0,18,5,13,4,3,1,2,10
Sun 22 Mar 2020 07:00,0,0,0,22,9,13,12,10,2,9,8
Sun 22 Mar 2020 08:00,2,1,1,35,13,22,6,4,2,7,22
Sun 22 Mar 2020 09:00,4,3,1,59,22,37,14,11,3,19,16
Sun 22 Mar 2020 10:00,7,4,3,76,32,44,23,19,4,40,26
Sun 22 Mar 2020 11:00,4,3,1,98,25,73,41,20,21,40,25
Sun 22 Mar 2020 12:00,6,4,2,105,42,63,57,34,23,76,29
Sun 22 Mar 2020 13:00,9,5,4,131,59,72,56,31,25,73,36
Sun 22 Mar 2020 14:00,5,2,3,158,77,81,59,28,31,79,50
Sun 22 Mar 2020 15:00,12,6,6,128,55,73,62,29,33,68,61
Sun 22 Mar 2020 16:00,12,8,4,108,49,59,49,28,21,41,73
Sun 22 Mar 2020 17:00,16,8,8,77,41,36,40,26,14,44,51
Sun 22 Mar 2020 18:00,1,1,0,79,49,30,22,13,9,32,33
Sun 22 Mar 2020 19:00,1,0,1,66,45,21,23,16,7,27,9
Sun 22 Mar 2020 20:00,2,2,0,47,27,20,18,10,8,18,15
Sun 22 Mar 2020 21:00,1,0,1,34,19,15,17,6,11,15,5
Sun 22 Mar 2020 22:00,0,0,0,12,10,2,7,5,2,8,7
Sun 22 Mar 2020 23:00,1,0,1,6,3,3,4,2,2,9,2
Mon 23 Mar 2020 00:00,0,0,0,1,1,0,0,0,0,3,2
Mon 23 Mar 2020 01:00,0,0,0,5,2,3,0,0,0,1,1
Mon 23 Mar 2020 02:00,0,0,0,2,1,1,1,1,0,0,0
Mon 23 Mar 2020 03:00,0,0,0,3,2,1,1,1,0,0,0
Mon 23 Mar 2020 04:00,0,0,0,3,1,2,2,2,0,0,1
Mon 23 Mar 2020 05:00,0,0,0,15,1,14,8,8,0,4,10
Mon 23 Mar 2020 06:00,1,1,0,83,19,64,59,56,3,6,59
Mon 23 Mar 2020 07:00,4,2,2,141,33,108,73,64,9,17,116
Mon 23 Mar 2020 08:00,6,3,3,212,46,166,63,58,5,24,132
Mon 23 Mar 2020 09:00,7,5,2,106,28,78,31,24,7,20,78
Mon 23 Mar 2020 10:00,1,1,0,47,16,31,26,13,13,18,25
Mon 23 Mar 2020 11:00,5,3,2,51,19,32,22,17,5,25,32
Mon 23 Mar 2020 12:00,8,5,3,84,41,43,26,22,4,35,34
Mon 23 Mar 2020 13:00,1,1,0,94,45,49,34,19,15,53,41
Mon 23 Mar 2020 14:00,9,6,3,91,44,47,28,16,12,59,37
Mon 23 Mar 2020 15:00,5,5,0,98,60,38,36,20,16,61,39
Mon 23 Mar 2020 16:00,6,2,4,117,67,50,52,26,26,105,40
Mon 23 Mar 2020 17:00,8,4,4,174,107,67,49,29,20,160,34
Mon 23 Mar 2020 18:00,4,2,2,152,95,57,60,25,35,100,30
Mon 23 Mar 2020 19:00,2,1,1,101,43,58,27,13,14,39,22
Mon 23 Mar 2020 20:00,3,3,0,42,20,22,23,11,12,27,10
Mon 23 Mar 2020 21:00,3,2,1,29,24,5,19,12,7,19,11
Mon 23 Mar 2020 22:00,0,0,0,19,17,2,8,6,2,14,5
Mon 23 Mar 2020 23:00,0,0,0,9,6,3,6,5,1,6,0
Tue 24 Mar 2020 00:00,2,0,2,3,3,0,1,0,1,3,2
Tue 24 Mar 2020 01:00,0,0,0,1,0,1,0,0,0,2,1
Tue 24 Mar 2020 02:00,0,0,0,1,1,0,0,0,0,1,0
Tue 24 Mar 2020 03:00,0,0,0,4,3,1,1,1,0,0,0
Tue 24 Mar 2020 04:00,0,0,0,5,1,4,2,2,0,2,4
Tue 24 Mar 2020 05:00,0,0,0,20,5,15,6,6,0,2,9
Tue 24 Mar 2020 06:00,3,3,0,61,10,51,64,63,1,13,53
Tue 24 Mar 2020 07:00,5,3,2,150,32,118,67,56,11,24,93
Tue 24 Mar 2020 08:00,3,3,0,196,48,148,65,57,8,24,114
Tue 24 Mar 2020 09:00,6,3,3,89,25,64,27,23,4,13,66
Tue 24 Mar 2020 10:00,3,2,1,45,16,29,25,19,6,24,34
Tue 24 Mar 2020 11:00,3,2,1,69,25,44,18,13,5,25,28
Tue 24 Mar 2020 12:00,2,1,1,82,36,46,25,18,7,41,26
Tue 24 Mar 2020 13:00,7,5,2,84,42,42,40,22,18,49,32
Tue 24 Mar 2020 14:00,4,2,2,80,39,41,32,17,15,51,38
Tue 24 Mar 2020 15:00,6,5,1,88,47,41,36,22,14,70,31
Tue 24 Mar 2020 16:00,3,2,1,121,71,50,50,27,23,99,41
Tue 24 Mar 2020 17:00,7,5,2,201,113,88,56,30,26,135,38
Tue 24 Mar 2020 18:00,2,2,0,162,95,67,45,25,20,111,52
Tue 24 Mar 2020 19:00,9,7,2,74,37,37,27,17,10,34,18
Tue 24 Mar 2020 20:00,1,0,1,70,42,28,25,12,13,26,9
Tue 24 Mar 2020 21:00,11,2,9,29,20,9,14,10,4,20,11
Tue 24 Mar 2020 22:00,6,4,2,16,11,5,3,3,0,13,5
Tue 24 Mar 2020 23:00,1,1,0,6,3,3,3,3,0,8,2
Wed 25 Mar 2020 00:00,0,0,0,2,1,1,0,0,0,4,2
Wed 25 Mar 2020 01:00,0,0,0,1,1,0,0,0,0,1,0
Wed 25 Mar 2020 02:00,0,0,0,1,0,1,0,0,0,2,0
Wed 25 Mar 2020 03:00,0,0,0,4,3,1,2,2,0,1,1
Wed 25 Mar 2020 04:00,1,1,0,7,2,5,4,4,0,1,4
Wed 25 Mar 2020 05:00,0,0,0,22,6,16,6,5,1,4,12
Wed 25 Mar 2020 06:00,2,2,0,73,14,59,65,61,4,18,54
Wed 25 Mar 2020 07:00,6,5,1,142,35,107,66,58,8,16,99
Wed 25 Mar 2020 08:00,6,5,1,163,43,120,62,53,9,25,119
Wed 25 Mar 2020 09:00,6,5,1,104,24,80,33,30,3,22,58
Wed 25 Mar 2020 10:00,3,2,1,65,25,40,19,13,6,21,30
Wed 25 Mar 2020 11:00,4,4,0,65,25,40,22,16,6,27,37
Wed 25 Mar 2020 12:00,3,2,1,102,40,62,30,14,16,39,29
Wed 25 Mar 2020 13:00,6,2,4,120,55,65,45,32,13,50,64
Wed 25 Mar 2020 14:00,6,4,2,110,52,58,39,20,19,54,41
Wed 25 Mar 2020 15:00,5,3,2,118,60,58,42,14,28,65,28
Wed 25 Mar 2020 16:00,8,3,5,156,92,64,50,32,18,103,27
Wed 25 Mar 2020 17:00,9,3,6,207,120,87,69,37,32,139,60
Wed 25 Mar 2020 18:00,7,2,5,163,87,76,56,26,30,93,40
Wed 25 Mar 2020 19:00,2,0,2,82,39,43,40,17,23,35,12
Wed 25 Mar 2020 20:00,3,2,1,50,32,18,29,19,10,31,7
Wed 25 Mar 2020 21:00,0,0,0,37,24,13,12,8,4,17,5
Wed 25 Mar 2020 22:00,3,1,2,22,15,7,6,3,3,9,7
Wed 25 Mar 2020 23:00,2,1,1,6,4,2,1,1,0,4,1
Thu 26 Mar 2020 00:00,0,0,0,3,1,2,1,0,1,4,2
Thu 26 Mar 2020 01:00,0,0,0,3,2,1,0,0,0,1,0
Thu 26 Mar 2020 02:00,1,0,1,1,0,1,0,0,0,0,0
Thu 26 Mar 2020 03:00,0,0,0,2,2,0,1,1,0,0,1
Thu 26 Mar 2020 04:00,0,0,0,9,3,6,2,2,0,0,4
Thu 26 Mar 2020 05:00,0,0,0,17,3,14,6,6,0,3,12
Thu 26 Mar 2020 06:00,3,3,0,71,15,56,60,58,2,16,54
Thu 26 Mar 2020 07:00,3,2,1,126,30,96,65,55,10,20,97
Thu 26 Mar 2020 08:00,3,2,1,169,50,119,49,43,6,22,104
Thu 26 Mar 2020 09:00,1,1,0,78,23,55,37,30,7,11,42
Thu 26 Mar 2020 10:00,3,2,1,68,24,44,18,13,5,27,31
Thu 26 Mar 2020 11:00,3,3,0,54,19,35,17,9,8,25,18
Thu 26 Mar 2020 12:00,0,0,0,84,39,45,34,28,6,37,30
Thu 26 Mar 2020 13:00,4,3,1,95,50,45,40,27,13,47,24
Thu 26 Mar 2020 14:00,8,5,3,108,56,52,28,13,15,39,30
Thu 26 Mar 2020 15:00,4,4,0,126,68,58,35,19,16,64,24
Thu 26 Mar 2020 16:00,5,3,2,150,80,70,55,37,18,100,44
Thu 26 Mar 2020 17:00,5,3,2,206,112,94,45,31,14,126,45
Thu 26 Mar 2020 18:00,6,3,3,164,86,78,48,25,23,80,37
Thu 26 Mar 2020 19:00,0,0,0,95,50,45,39,20,19,38,23
Thu 26 Mar 2020 20:00,3,2,1,49,31,18,21,13,8,28,15
Thu 26 Mar 2020 21:00,2,1,1,40,25,15,10,5,5,21,13
Thu 26 Mar 2020 22:00,1,1,0,26,16,10,6,4,2,11,6
Thu 26 Mar 2020 23:00,0,0,0,6,4,2,2,1,1,6,1
Fri 27 Mar 2020 00:00,0,0,0,0,0,0,0,0,0,3,0
Fri 27 Mar 2020 01:00,0,0,0,1,1,0,0,0,0,1,0
Fri 27 Mar 2020 02:00,0,0,0,2,1,1,1,0,1,3,0
Fri 27 Mar 2020 03:00,0,0,0,3,3,0,1,1,0,0,0
Fri 27 Mar 2020 04:00,1,1,0,5,3,2,0,0,0,1,0
Fri 27 Mar 2020 05:00,0,0,0,16,3,13,8,7,1,4,15
Fri 27 Mar 2020 06:00,4,4,0,67,10,57,55,54,1,10,51
Fri 27 Mar 2020 07:00,2,2,0,120,27,93,50,46,4,21,78
Fri 27 Mar 2020 08:00,3,2,1,152,34,118,47,42,5,20,98
Fri 27 Mar 2020 09:00,4,3,1,86,28,58,29,27,2,17,58
Fri 27 Mar 2020 10:00,5,2,3,49,14,35,17,14,3,7,25
Fri 27 Mar 2020 11:00,0,0,0,85,43,42,23,16,7,26,22
Fri 27 Mar 2020 12:00,3,1,2,72,33,39,23,16,7,36,34
Fri 27 Mar 2020 13:00,3,1,2,84,44,40,36,24,12,48,50
Fri 27 Mar 2020 14:00,6,3,3,107,53,54,29,20,9,55,23
Fri 27 Mar 2020 15:00,3,2,1,90,46,44,27,13,14,65,38
Fri 27 Mar 2020 16:00,9,4,5,112,62,50,51,31,20,74,24
Fri 27 Mar 2020 17:00,6,4,2,138,85,53,60,32,28,124,43
Fri 27 Mar 2020 18:00,5,3,2,136,82,54,35,21,14,80,48
Fri 27 Mar 2020 19:00,3,1,2,96,40,56,21,11,10,38,26
Fri 27 Mar 2020 20:00,2,1,1,66,37,29,21,12,9,30,17
Fri 27 Mar 2020 21:00,1,1,0,51,28,23,28,14,14,18,15
Fri 27 Mar 2020 22:00,1,1,0,42,25,17,25,17,8,17,12
Fri 27 Mar 2020 23:00,1,0,1,18,12,6,3,0,3,8,3
Sat 28 Mar 2020 00:00,1,1,0,5,3,2,0,0,0,3,3
Sat 28 Mar 2020 01:00,0,0,0,3,2,1,0,0,0,4,0
Sat 28 Mar 2020 02:00,0,0,0,1,1,0,0,0,0,2,0
Sat 28 Mar 2020 03:00,0,0,0,5,4,1,0,0,0,0,0
Sat 28 Mar 2020 04:00,0,0,0,4,1,3,1,1,0,0,1
Sat 28 Mar 2020 05:00,0,0,0,7,1,6,4,3,1,1,0
Sat 28 Mar 2020 06:00,1,1,0,16,6,10,10,9,1,3,13
Sat 28 Mar 2020 07:00,0,0,0,34,12,22,19,16,3,7,18
Sat 28 Mar 2020 08:00,1,1,0,24,7,17,6,6,0,8,18
Sat 28 Mar 2020 09:00,1,0,1,44,16,28,7,5,2,5,10
Sat 28 Mar 2020 10:00,1,0,1,25,9,16,8,5,3,13,5
Sat 28 Mar 2020 11:00,4,3,1,42,12,30,13,10,3,12,9
Sat 28 Mar 2020 12:00,2,1,1,28,14,14,12,8,4,16,15
Sat 28 Mar 2020 13:00,3,3,0,49,25,24,10,5,5,21,14
Sat 28 Mar 2020 14:00,3,2,1,44,19,25,26,21,5,24,13
Sat 28 Mar 2020 15:00,4,3,1,31,11,20,13,10,3,29,16
Sat 28 Mar 2020 16:00,4,2,2,46,25,21,16,10,6,26,21
Sat 28 Mar 2020 17:00,3,1,2,47,24,23,18,13,5,16,23
Sat 28 Mar 2020 18:00,8,3,5,58,27,31,25,14,11,27,30
Sat 28 Mar 2020 19:00,4,3,1,62,29,33,23,15,8,36,7
Sat 28 Mar 2020 20:00,4,4,0,49,29,20,14,9,5,12,8
Sat 28 Mar 2020 21:00,0,0,0,33,19,14,7,4,3,9,9
Sat 28 Mar 2020 22:00,1,0,1,19,13,6,11,8,3,17,4
Sat 28 Mar 2020 23:00,1,1,0,6,3,3,4,0,4,9,2
Sun 29 Mar 2020 00:00,0,0,0,5,4,1,2,0,2,2,1
Sun 29 Mar 2020 01:00,0,0,0,0,0,0,0,0,0,0,0
Sun 29 Mar 2020 02:00,0,0,0,0,0,0,0,0,0,2,0
Sun 29 Mar 2020 03:00,0,0,0,0,0,0,1,1,0,0,0
Sun 29 Mar 2020 04:00,0,0,0,3,2,1,0,0,0,0,1
Sun 29 Mar 2020 05:00,0,0,0,4,1,3,2,2,0,1,0
Sun 29 Mar 2020 06:00,0,0,0,13,4,9,2,2,0,3,5
Sun 29 Mar 2020 07:00,2,0,2,18,5,13,7,6,1,4,8
Sun 29 Mar 2020 08:00,0,0,0,18,5,13,5,4,1,4,6
Sun 29 Mar 2020 09:00,1,0,1,17,5,12,4,4,0,3,10
Sun 29 Mar 2020 10:00,0,0,0,24,9,15,3,2,1,8,11
Sun 29 Mar 2020 11:00,0,0,0,36,15,21,7,6,1,8,11
Sun 29 Mar 2020 12:00,2,1,1,37,14,23,4,3,1,10,7
Sun 29 Mar 2020 13:00,2,1,1,36,26,10,23,16,7,11,6
Sun 29 Mar 2020 14:00,4,2,2,40,13,27,19,13,6,11,7
Sun 29 Mar 2020 15:00,5,3,2,39,14,25,19,14,5,18,11
Sun 29 Mar 2020 16:00,5,4,1,49,23,26,13,11,2,23,8
Sun 29 Mar 2020 17:00,0,0,0,66,31,35,23,18,5,14,19
Sun 29 Mar 2020 18:00,5,3,2,61,23,38,22,14,8,34,25
Sun 29 Mar 2020 19:00,2,1,1,60,30,30,19,13,6,23,26
Sun 29 Mar 2020 20:00,2,1,1,47,27,20,13,8,5,18,5
Sun 29 Mar 2020 21:00,0,0,0,25,14,11,10,8,2,11,7
Sun 29 Mar 2020 22:00,2,1,1,12,10,2,6,4,2,5,4
Sun 29 Mar 2020 23:00,0,0,0,8,3,5,2,0,2,4,0
Mon 30 Mar 2020 00:00,0,0,0,3,3,0,0,0,0,6,2
Mon 30 Mar 2020 01:00,0,0,0,1,1,0,0,0,0,0,0
Mon 30 Mar 2020 02:00,0,0,0,1,1,0,0,0,0,0,0
Mon 30 Mar 2020 03:00,0,0,0,2,2,0,1,1,0,1,0
Mon 30 Mar 2020 04:00,0,0,0,4,1,3,1,1,0,0,2
Mon 30 Mar 2020 05:00,1,0,1,16,4,12,4,4,0,2,6
Mon 30 Mar 2020 06:00,1,1,0,25,8,17,12,10,2,8,28
Mon 30 Mar 2020 07:00,2,1,1,82,33,49,36,30,6,11,50
Mon 30 Mar 2020 08:00,3,1,2,92,27,65,40,38,2,12,59
Mon 30 Mar 2020 09:00,3,1,2,53,21,32,17,14,3,11,42
Mon 30 Mar 2020 10:00,0,0,0,31,12,19,11,7,4,14,9
Mon 30 Mar 2020 11:00,1,1,0,38,12,26,4,3,1,14,17
Mon 30 Mar 2020 12:00,2,1,1,44,24,20,13,11,2,28,24
Mon 30 Mar 2020 13:00,4,0,4,57,25,32,19,10,9,27,17
Mon 30 Mar 2020 14:00,0,0,0,42,26,16,15,10,5,27,20
Mon 30 Mar 2020 15:00,5,4,1,63,27,36,11,8,3,27,24
Mon 30 Mar 2020 16:00,6,2,4,67,32,35,26,15,11,47,15
Mon 30 Mar 2020 17:00,2,1,1,98,58,40,40,20,20,51,19
Mon 30 Mar 2020 18:00,5,4,1,81,41,40,32,19,13,44,9
Mon 30 Mar 2020 19:00,3,2,1,54,24,30,15,11,4,30,17
Mon 30 Mar 2020 20:00,4,1,3,53,25,28,19,14,5,14,15
Mon 30 Mar 2020 21:00,0,0,0,30,18,12,7,3,4,11,9
Mon 30 Mar 2020 22:00,3,2,1,13,10,3,6,3,3,10,4
Mon 30 Mar 2020 23:00,1,0,1,6,4,2,2,0,2,6,1
Tue 31 Mar 2020 00:00,1,1,0,2,1,1,1,1,0,2,3
Tue 31 Mar 2020 01:00,0,0,0,1,0,1,1,0,1,1,0
Tue 31 Mar 2020 02:00,0,0,0,1,0,1,1,0,1,0,0
Tue 31 Mar 2020 03:00,0,0,0,0,0,0,1,1,0,0,0
Tue 31 Mar 2020 04:00,0,0,0,7,4,3,1,1,0,2,2
Tue 31 Mar 2020 05:00,0,0,0,9,3,6,3,3,0,1,3
Tue 31 Mar 2020 06:00,1,1,0,31,10,21,12,12,0,8,20
Tue 31 Mar 2020 07:00,3,2,1,67,19,48,31,25,6,11,52
Tue 31 Mar 2020 08:00,2,1,1,97,32,65,32,28,4,17,54
Tue 31 Mar 2020 09:00,0,0,0,51,21,30,9,6,3,11,31
Tue 31 Mar 2020 10:00,3,1,2,43,19,24,5,5,0,6,15
Tue 31 Mar 2020 11:00,2,1,1,33,14,19,10,7,3,11,13
Tue 31 Mar 2020 12:00,2,1,1,55,28,27,12,9,3,25,23
Tue 31 Mar 2020 13:00,0,0,0,66,32,34,16,10,6,20,22
Tue 31 Mar 2020 14:00,4,4,0,46,21,25,20,13,7,25,16
Tue 31 Mar 2020 15:00,0,0,0,43,21,22,22,18,4,24,17
Tue 31 Mar 2020 16:00,6,3,3,95,44,51,26,16,10,49,22
Tue 31 Mar 2020 17:00,7,5,2,118,60,58,38,25,13,59,31
Tue 31 Mar 2020 18:00,5,2,3,107,50,57,27,20,7,52,30
Tue 31 Mar 2020 19:00,6,1,5,75,37,38,23,16,7,34,16
Tue 31 Mar 2020 20:00,2,1,1,58,27,31,14,7,7,25,9
Tue 31 Mar 2020 21:00,7,5,2,30,15,15,12,6,6,22,10
Tue 31 Mar 2020 22:00,2,1,1,17,9,8,3,1,2,14,7
Tue 31 Mar 2020 23:00,0,0,0,7,5,2,3,1,2,6,0
Wed 1 Apr 2020 00:00,0,0,0,4,2,2,1,0,1,3,2
Wed 1 Apr 2020 01:00,0,0,0,2,1,1,0,0,0,0,1
Wed 1 Apr 2020 02:00,0,0,0,0,0,0,1,0,1,0,1
Wed 1 Apr 2020 03:00,0,0,0,4,4,0,1,1,0,1,0
Wed 1 Apr 2020 04:00,1,0,1,7,2,5,1,1,0,1,5
Wed 1 Apr 2020 05:00,0,0,0,7,2,5,4,4,0,3,5
Wed 1 Apr 2020 06:00,2,1,1,31,11,20,9,8,1,10,18
Wed 1 Apr 2020 07:00,1,0,1,61,24,37,28,24,4,11,41
Wed 1 Apr 2020 08:00,4,2,2,113,41,72,33,28,5,14,57
Wed 1 Apr 2020 09:00,3,3,0,48,19,29,8,8,0,9,28
Wed 1 Apr 2020 10:00,0,0,0,32,10,22,5,2,3,6,10
Wed 1 Apr 2020 11:00,2,1,1,31,12,19,8,5,3,14,21
Wed 1 Apr 2020 12:00,2,0,2,55,27,28,13,9,4,17,13
Wed 1 Apr 2020 13:00,5,3,2,54,29,25,24,12,12,28,23
Wed 1 Apr 2020 14:00,2,2,0,54,23,31,21,12,9,32,21
Wed 1 Apr 2020 15:00,4,3,1,66,30,36,16,12,4,31,9
Wed 1 Apr 2020 16:00,5,1,4,87,44,43,31,19,12,44,25
Wed 1 Apr 2020 17:00,4,3,1,113,60,53,29,25,4,54,23
Wed 1 Apr 2020 18:00,9,6,3,109,48,61,34,22,12,47,27
Wed 1 Apr 2020 19:00,5,3,2,85,34,51,27,21,6,21,18
Wed 1 Apr 2020 20:00,3,3,0,50,22,28,7,4,3,23,2
Wed 1 Apr 2020 21:00,3,2,1,29,20,9,11,7,4,14,7
Wed 1 Apr 2020 22:00,2,1,1,15,12,3,7,4,3,14,8
Wed 1 Apr 2020 23:00,0,0,0,7,2,5,2,2,0,5,2
Thu 2 Apr 2020 00:00,0,0,0,11,5,6,0,0,0,7,2
Thu 2 Apr 2020 01:00,0,0,0,1,0,1,0,0,0,0,1
Thu 2 Apr 2020 02:00,0,0,0,3,2,1,0,0,0,1,1
Thu 2 Apr 2020 03:00,0,0,0,2,2,0,0,0,0,0,0
Thu 2 Apr 2020 04:00,0,0,0,5,2,3,2,2,0,0,3
Thu 2 Apr 2020 05:00,0,0,0,8,3,5,4,4,0,1,2
Thu 2 Apr 2020 06:00,1,1,0,30,9,21,17,13,4,8,18
Thu 2 Apr 2020 07:00,0,0,0,77,31,46,27,25,2,5,45
Thu 2 Apr 2020 08:00,4,3,1,92,27,65,31,28,3,19,54
Thu 2 Apr 2020 09:00,1,0,1,47,13,34,12,10,2,6,26
Thu 2 Apr 2020 10:00,2,1,1,39,16,23,3,3,0,11,15
Thu 2 Apr 2020 11:00,1,1,0,26,8,18,9,5,4,14,13
Thu 2 Apr 2020 12:00,1,1,0,42,21,21,15,8,7,7,12
Thu 2 Apr 2020 13:00,2,0,2,48,27,21,27,18,9,28,15
Thu 2 Apr 2020 14:00,4,3,1,47,24,23,28,14,14,38,12
Thu 2 Apr 2020 15:00,5,4,1,65,31,34,10,6,4,31,12
Thu 2 Apr 2020 16:00,5,4,1,84,41,43,22,13,9,35,13
Thu 2 Apr 2020 17:00,7,5,2,113,57,56,34,21,13,44,26
Thu 2 Apr 2020 18:00,9,5,4,103,56,47,29,16,13,41,21
Thu 2 Apr 2020 19:00,3,2,1,77,41,36,39,29,10,40,14
Thu 2 Apr 2020 20:00,2,0,2,52,28,24,16,7,9,22,18
Thu 2 Apr 2020 21:00,0,0,0,29,14,15,21,15,6,19,14
Thu 2 Apr 2020 22:00,3,2,1,14,10,4,5,2,3,9,3
Thu 2 Apr 2020 23:00,0,0,0,5,4,1,1,0,1,5,1
Fri 3 Apr 2020 00:00,0,0,0,3,0,3,1,1,0,3,0
Fri 3 Apr 2020 01:00,0,0,0,7,5,2,0,0,0,2,1
Fri 3 Apr 2020 02:00,0,0,0,2,1,1,1,0,1,0,0
Fri 3 Apr 2020 03:00,0,0,0,3,3,0,1,1,0,0,0
Fri 3 Apr 2020 04:00,0,0,0,6,2,4,0,0,0,1,3
Fri 3 Apr 2020 05:00,0,0,0,6,3,3,2,2,0,3,6
Fri 3 Apr 2020 06:00,0,0,0,30,9,21,13,13,0,5,25
Fri 3 Apr 2020 07:00,1,0,1,67,24,43,29,23,6,6,48
Fri 3 Apr 2020 08:00,2,1,1,97,35,62,28,26,2,14,50
Fri 3 Apr 2020 09:00,3,1,2,61,21,40,10,10,0,9,24
Fri 3 Apr 2020 10:00,2,1,1,47,24,23,13,11,2,9,20
Fri 3 Apr 2020 11:00,3,2,1,49,22,27,20,16,4,21,9
Fri 3 Apr 2020 12:00,2,0,2,61,23,38,19,11,8,16,25
Fri 3 Apr 2020 13:00,5,1,4,85,34,51,23,17,6,41,30
Fri 3 Apr 2020 14:00,7,4,3,64,33,31,27,20,7,32,23
Fri 3 Apr 2020 15:00,2,2,0,61,27,34,16,11,5,34,20
Fri 3 Apr 2020 16:00,2,1,1,71,36,35,32,18,14,40,15
Fri 3 Apr 2020 17:00,5,5,0,91,43,48,45,30,15,54,27
Fri 3 Apr 2020 18:00,7,6,1,110,60,50,37,25,12,60,36
Fri 3 Apr 2020 19:00,4,0,4,85,42,43,18,15,3,28,29
Fri 3 Apr 2020 20:00,4,3,1,74,40,34,21,14,7,26,15
Fri 3 Apr 2020 21:00,2,1,1,54,29,25,18,13,5,22,15
Fri 3 Apr 2020 22:00,1,0,1,22,13,9,15,9,6,13,11
Fri 3 Apr 2020 23:00,0,0,0,12,7,5,4,1,3,9,1
Sat 4 Apr 2020 00:00,0,0,0,5,4,1,0,0,0,2,1
Sat 4 Apr 2020 01:00,2,1,1,1,1,0,1,1,0,1,1
Sat 4 Apr 2020 02:00,0,0,0,0,0,0,1,0,1,0,1
Sat 4 Apr 2020 03:00,0,0,0,3,3,0,0,0,0,0,0
Sat 4 Apr 2020 04:00,0,0,0,4,2,2,1,1,0,0,1
Sat 4 Apr 2020 05:00,0,0,0,8,2,6,3,3,0,3,4
Sat 4 Apr 2020 06:00,2,0,2,22,8,14,8,8,0,3,6
Sat 4 Apr 2020 07:00,0,0,0,30,17,13,15,13,2,9,13
Sat 4 Apr 2020 08:00,0,0,0,25,13,12,8,8,0,12,15
Sat 4 Apr 2020 09:00,5,2,3,28,10,18,16,11,5,11,25
Sat 4 Apr 2020 10:00,0,0,0,41,15,26,11,9,2,12,16
Sat 4 Apr 2020 11:00,3,1,2,52,18,34,7,2,5,30,22
Sat 4 Apr 2020 12:00,4,2,2,70,33,37,17,10,7,18,29
Sat 4 Apr 2020 13:00,7,3,4,93,50,43,29,22,7,28,26
Sat 4 Apr 2020 14:00,6,4,2,78,44,34,34,26,8,36,20
Sat 4 Apr 2020 15:00,1,1,0,87,34,53,11,9,2,31,27
Sat 4 Apr 2020 16:00,5,3,2,95,47,48,21,11,10,38,27
Sat 4 Apr 2020 17:00,2,1,1,81,38,43,27,17,10,37,25
Sat 4 Apr 2020 18:00,8,6,2,97,43,54,35,26,9,31,34
Sat 4 Apr 2020 19:00,0,0,0,66,36,30,37,22,15,33,25
Sat 4 Apr 2020 20:00,2,2,0,70,31,39,18,10,8,20,17
Sat 4 Apr 2020 21:00,1,1,0,51,28,23,11,6,5,12,5
Sat 4 Apr 2020 22:00,0,0,0,25,15,10,7,4,3,15,8
Sat 4 Apr 2020 23:00,0,0,0,12,6,6,6,2,4,3,2
Sun 5 Apr 2020 00:00,0,0,0,5,3,2,1,0,1,3,3
Sun 5 Apr 2020 01:00,0,0,0,0,0,0,0,0,0,0,0
Sun 5 Apr 2020 02:00,0,0,0,3,2,1,1,1,0,1,0
Sun 5 Apr 2020 03:00,0,0,0,0,0,0,0,0,0,0,0
Sun 5 Apr 2020 04:00,0,0,0,0,0,0,0,0,0,0,3
Sun 5 Apr 2020 05:00,0,0,0,4,0,4,1,1,0,1,1
Sun 5 Apr 2020 06:00,4,2,2,16,6,10,8,7,1,2,7
Sun 5 Apr 2020 07:00,0,0,0,19,6,13,7,6,1,5,6
Sun 5 Apr 2020 08:00,0,0,0,23,11,12,13,12,1,6,10
Sun 5 Apr 2020 09:00,2,1,1,36,20,16,8,6,2,5,8
Sun 5 Apr 2020 10:00,1,1,0,41,21,20,4,3,1,9,12
Sun 5 Apr 2020 11:00,6,4,2,66,23,43,12,9,3,11,24
Sun 5 Apr 2020 12:00,5,4,1,86,35,51,28,16,12,40,15
Sun 5 Apr 2020 13:00,4,2,2,95,55,40,21,16,5,25,17
Sun 5 Apr 2020 14:00,11,5,6,78,32,46,20,10,10,20,23
Sun 5 Apr 2020 15:00,7,4,3,81,32,49,15,6,9,27,20
Sun 5 Apr 2020 16:00,7,6,1,66,31,35,20,11,9,20,18
Sun 5 Apr 2020 17:00,3,2,1,72,37,35,17,14,3,15,11
Sun 5 Apr 2020 18:00,5,3,2,53,31,22,14,11,3,21,13
Sun 5 Apr 2020 19:00,2,2,0,45,25,20,19,13,6,22,10
Sun 5 Apr 2020 20:00,0,0,0,44,30,14,10,4,6,11,9
Sun 5 Apr 2020 21:00,3,3,0,32,14,18,8,6,2,8,9
Sun 5 Apr 2020 22:00,1,0,1,11,5,6,5,3,2,2,6
Sun 5 Apr 2020 23:00,0,0,0,8,6,2,4,1,3,4,3
Mon 6 Apr 2020 00:00,0,0,0,2,0,2,1,0,1,2,0
Mon 6 Apr 2020 01:00,0,0,0,0,0,0,0,0,0,1,1
Mon 6 Apr 2020 02:00,0,0,0,1,1,0,0,0,0,0,0
Mon 6 Apr 2020 03:00,0,0,0,6,5,1,0,0,0,1,2
Mon 6 Apr 2020 04:00,0,0,0,6,1,5,2,2,0,0,3
Mon 6 Apr 2020 05:00,1,0,1,10,3,7,2,2,0,0,3
Mon 6 Apr 2020 06:00,1,0,1,34,14,20,11,11,0,5,24
Mon 6 Apr 2020 07:00,4,2,2,80,34,46,27,25,2,10,46
Mon 6 Apr 2020 08:00,5,3,2,99,33,66,41,37,4,15,57
Mon 6 Apr 2020 09:00,4,2,2,49,15,34,12,7,5,4,32
Mon 6 Apr 2020 10:00,2,1,1,35,18,17,9,4,5,11,15
Mon 6 Apr 2020 11:00,2,2,0,45,18,27,8,5,3,25,14
Mon 6 Apr 2020 12:00,2,1,1,61,28,33,14,11,3,16,21
Mon 6 Apr 2020 13:00,6,3,3,77,47,30,29,20,9,28,21
Mon 6 Apr 2020 14:00,4,4,0,76,28,48,17,12,5,32,22
Mon 6 Apr 2020 15:00,2,0,2,86,43,43,23,10,13,38,18
Mon 6 Apr 2020 16:00,9,8,1,100,45,55,41,24,17,57,35
Mon 6 Apr 2020 17:00,6,2,4,133,71,62,42,24,18,66,34
Mon 6 Apr 2020 18:00,11,4,7,116,59,57,34,18,16,54,25
Mon 6 Apr 2020 19:00,6,3,3,91,41,50,28,18,10,27,19
Mon 6 Apr 2020 20:00,5,3,2,69,30,39,15,5,10,15,23
Mon 6 Apr 2020 21:00,5,3,2,28,21,7,14,5,9,18,9
Mon 6 Apr 2020 22:00,2,2,0,23,9,14,5,1,4,10,6
Mon 6 Apr 2020 23:00,1,1,0,13,10,3,7,3,4,7,1
Tue 7 Apr 2020 00:00,0,0,0,4,3,1,2,0,2,4,3
Tue 7 Apr 2020 01:00,0,0,0,0,0,0,0,0,0,1,1
Tue 7 Apr 2020 02:00,0,0,0,0,0,0,1,0,1,1,0
Tue 7 Apr 2020 03:00,0,0,0,3,3,0,1,1,0,0,0
Tue 7 Apr 2020 04:00,0,0,0,5,1,4,4,3,1,1,4
Tue 7 Apr 2020 05:00,1,0,1,8,2,6,1,0,1,1,5
Tue 7 Apr 2020 06:00,1,1,0,35,11,24,13,13,0,10,25
Tue 7 Apr 2020 07:00,2,2,0,76,24,52,28,24,4,9,49
Tue 7 Apr 2020 08:00,4,3,1,89,28,61,36,30,6,17,55
Tue 7 Apr 2020 09:00,1,1,0,51,17,34,10,10,0,15,28
Tue 7 Apr 2020 10:00,1,0,1,32,17,15,9,6,3,17,14
Tue 7 Apr 2020 11:00,7,3,4,48,14,34,10,6,4,24,25
Tue 7 Apr 2020 12:00,5,4,1,80,33,47,27,18,9,41,28
Tue 7 Apr 2020 13:00,2,1,1,99,42,57,39,22,17,39,19
Tue 7 Apr 2020 14:00,10,7,3,107,54,53,33,16,17,35,37
Tue 7 Apr 2020 15:00,8,6,2,94,41,53,34,25,9,47,41
Tue 7 Apr 2020 16:00,13,8,5,139,54,85,37,23,14,81,44
Tue 7 Apr 2020 17:00,10,5,5,179,93,86,47,30,17,76,39
Tue 7 Apr 2020 18:00,7,2,5,165,85,80,46,31,15,62,35
Tue 7 Apr 2020 19:00,8,6,2,108,52,56,25,15,10,46,31
Tue 7 Apr 2020 20:00,5,1,4,79,45,34,29,19,10,21,26
Tue 7 Apr 2020 21:00,1,1,0,23,16,7,13,7,6,26,12
Tue 7 Apr 2020 22:00,3,1,2,23,16,7,4,1,3,8,7
Tue 7 Apr 2020 23:00,0,0,0,4,2,2,2,2,0,7,3
Wed 8 Apr 2020 00:00,2,1,1,4,2,2,3,0,3,2,2
Wed 8 Apr 2020 01:00,0,0,0,0,0,0,0,0,0,1,0
Wed 8 Apr 2020 02:00,0,0,0,1,1,0,1,0,1,2,0
Wed 8 Apr 2020 03:00,0,0,0,3,2,1,1,1,0,1,2
Wed 8 Apr 2020 04:00,0,0,0,7,3,4,2,2,0,1,1
Wed 8 Apr 2020 05:00,2,1,1,11,2,9,3,2,1,2,4
Wed 8 Apr 2020 06:00,2,1,1,40,13,27,13,13,0,6,23
Wed 8 Apr 2020 07:00,3,2,1,91,47,44,28,25,3,9,50
Wed 8 Apr 2020 08:00,5,2,3,113,42,71,38,34,4,16,57
Wed 8 Apr 2020 09:00,2,1,1,66,22,44,9,6,3,20,29
Wed 8 Apr 2020 10:00,1,1,0,38,15,23,7,5,2,10,16
Wed 8 Apr 2020 11:00,4,0,4,65,21,44,15,10,5,34,19
Wed 8 Apr 2020 12:00,3,2,1,70,32,38,12,5,7,36,24
Wed 8 Apr 2020 13:00,6,4,2,83,37,46,32,24,8,38,26
Wed 8 Apr 2020 14:00,8,6,2,91,41,50,22,16,6,41,32
Wed 8 Apr 2020 15:00,4,3,1,103,52,51,29,17,12,46,25
Wed 8 Apr 2020 16:00,4,2,2,93,45,48,31,16,15,51,36
Wed 8 Apr 2020 17:00,6,4,2,156,79,77,40,24,16,71,37
Wed 8 Apr 2020 18:00,12,8,4,136,66,70,33,19,14,68,33
Wed 8 Apr 2020 19:00,4,0,4,113,61,52,25,17,8,35,26
Wed 8 Apr 2020 20:00,3,1,2,70,35,35,18,12,6,12,16
Wed 8 Apr 2020 21:00,3,2,1,21,9,12,16,7,9,27,8
Wed 8 Apr 2020 22:00,1,1,0,22,14,8,5,5,0,5,4
Wed 8 Apr 2020 23:00,0,0,0,7,6,1,1,0,1,5,0
Thu 9 Apr 2020 00:00,2,0,2,4,2,2,0,0,0,4,1
Thu 9 Apr 2020 01:00,0,0,0,0,0,0,0,0,0,1,1
Thu 9 Apr 2020 02:00,0,0,0,3,2,1,0,0,0,0,0
Thu 9 Apr 2020 03:00,1,0,1,2,1,1,0,0,0,1,0
Thu 9 Apr 2020 04:00,0,0,0,7,3,4,2,2,0,3,5
Thu 9 Apr 2020 05:00,0,0,0,10,2,8,1,1,0,2,6
Thu 9 Apr 2020 06:00,2,1,1,37,12,25,11,11,0,7,24
Thu 9 Apr 2020 07:00,1,1,0,90,46,44,38,30,8,7,53
Thu 9 Apr 2020 08:00,0,0,0,108,36,72,31,28,3,18,61
Thu 9 Apr 2020 09:00,4,0,4,56,15,41,11,8,3,12,30
Thu 9 Apr 2020 10:00,1,0,1,45,14,31,16,10,6,20,25
Thu 9 Apr 2020 11:00,2,2,0,57,28,29,10,6,4,15,25
Thu 9 Apr 2020 12:00,1,1,0,74,32,42,19,14,5,29,24
Thu 9 Apr 2020 13:00,5,2,3,74,32,42,20,14,6,32,18
Thu 9 Apr 2020 14:00,1,1,0,79,39,40,29,16,13,32,24
Thu 9 Apr 2020 15:00,3,2,1,77,37,40,19,16,3,42,26
Thu 9 Apr 2020 16:00,2,2,0,120,58,62,26,17,9,65,23
Thu 9 Apr 2020 17:00,3,0,3,134,74,60,39,27,12,60,30
Thu 9 Apr 2020 18:00,11,10,1,115,55,60,32,25,7,74,34
Thu 9 Apr 2020 19:00,6,2,4,73,37,36,15,12,3,41,19
Thu 9 Apr 2020 20:00,2,2,0,65,30,35,22,10,12,26,19
Thu 9 Apr 2020 21:00,4,1,3,47,26,21,12,10,2,13,14
Thu 9 Apr 2020 22:00,1,0,1,23,17,6,9,7,2,12,3
Thu 9 Apr 2020 23:00,0,0,0,8,6,2,4,3,1,8,0
Fri 10 Apr 2020 00:00,0,0,0,2,2,0,0,0,0,1,1
Fri 10 Apr 2020 01:00,0,0,0,0,0,0,0,0,0,0,0
Fri 10 Apr 2020 02:00,0,0,0,1,1,0,1,0,1,2,0
Fri 10 Apr 2020 03:00,0,0,0,1,1,0,0,0,0,1,1
Fri 10 Apr 2020 04:00,0,0,0,5,2,3,0,0,0,3,0
Fri 10 Apr 2020 05:00,0,0,0,12,0,12,3,3,0,2,5
Fri 10 Apr 2020 06:00,1,1,0,31,14,17,9,9,0,8,11
Fri 10 Apr 2020 07:00,0,0,0,53,27,26,18,14,4,6,22
Fri 10 Apr 2020 08:00,2,2,0,52,24,28,20,18,2,12,38
Fri 10 Apr 2020 09:00,5,5,0,51,25,26,11,9,2,12,19
Fri 10 Apr 2020 10:00,5,3,2,64,29,35,12,11,1,28,18
Fri 10 Apr 2020 11:00,8,5,3,91,38,53,12,5,7,37,23
Fri 10 Apr 2020 12:00,6,4,2,81,42,39,17,13,4,30,20
Fri 10 Apr 2020 13:00,5,3,2,108,51,57,27,20,7,39,37
Fri 10 Apr 2020 14:00,6,3,3,117,57,60,35,21,14,43,32
Fri 10 Apr 2020 15:00,3,0,3,118,66,52,22,14,8,38,30
Fri 10 Apr 2020 16:00,5,2,3,122,64,58,24,10,14,34,32
Fri 10 Apr 2020 17:00,3,3,0,133,57,76,39,26,13,40,25
Fri 10 Apr 2020 18:00,7,5,2,119,58,61,27,16,11,44,39
Fri 10 Apr 2020 19:00,7,3,4,98,42,56,35,26,9,39,27
Fri 10 Apr 2020 20:00,6,4,2,78,33,45,19,11,8,26,20
Fri 10 Apr 2020 21:00,3,0,3,64,40,24,13,13,0,20,16
Fri 10 Apr 2020 22:00,3,2,1,28,21,7,4,3,1,17,11
Fri 10 Apr 2020 23:00,2,1,1,12,8,4,6,4,2,10,6
Sat 11 Apr 2020 00:00,1,0,1,6,3,3,0,0,0,3,1
Sat 11 Apr 2020 01:00,0,0,0,2,2,0,2,1,1,0,0
Sat 11 Apr 2020 02:00,0,0,0,0,0,0,0,0,0,0,0
Sat 11 Apr 2020 03:00,0,0,0,2,1,1,0,0,0,1,2
Sat 11 Apr 2020 04:00,0,0,0,3,0,3,1,1,0,0,2
Sat 11 Apr 2020 05:00,0,0,0,6,1,5,1,1,0,1,5
Sat 11 Apr 2020 06:00,2,0,2,21,4,17,13,12,1,4,11
Sat 11 Apr 2020 07:00,0,0,0,24,15,9,7,5,2,14,11
Sat 11 Apr 2020 08:00,0,0,0,32,11,21,20,18,2,11,25
Sat 11 Apr 2020 09:00,4,3,1,45,20,25,9,6,3,8,14
Sat 11 Apr 2020 10:00,2,2,0,63,24,39,13,10,3,21,10
Sat 11 Apr 2020 11:00,2,2,0,98,47,51,18,12,6,22,17
Sat 11 Apr 2020 12:00,4,2,2,86,36,50,31,22,9,32,29
Sat 11 Apr 2020 13:00,10,4,6,92,35,57,38,27,11,43,30
Sat 11 Apr 2020 14:00,7,6,1,122,52,70,37,23,14,41,23
Sat 11 Apr 2020 15:00,11,5,6,137,49,88,66,52,14,48,42
Sat 11 Apr 2020 16:00,9,5,4,184,84,100,39,25,14,41,48
Sat 11 Apr 2020 17:00,11,7,4,121,59,62,62,40,22,48,45
Sat 11 Apr 2020 18:00,3,2,1,129,47,82,47,27,20,47,27
Sat 11 Apr 2020 19:00,5,3,2,107,43,64,31,22,9,37,33
Sat 11 Apr 2020 20:00,2,1,1,75,40,35,22,15,7,39,35
Sat 11 Apr 2020 21:00,7,4,3,35,22,13,13,4,9,18,11
Sat 11 Apr 2020 22:00,5,3,2,25,14,11,13,8,5,15,6
Sat 11 Apr 2020 23:00,0,0,0,9,7,2,3,1,2,9,3
Sun 12 Apr 2020 00:00,1,1,0,4,3,1,2,2,0,2,1
Sun 12 Apr 2020 01:00,0,0,0,0,0,0,2,1,1,2,1
Sun 12 Apr 2020 02:00,0,0,0,2,1,1,3,2,1,2,1
Sun 12 Apr 2020 03:00,0,0,0,2,2,0,0,0,0,0,0
Sun 12 Apr 2020 04:00,0,0,0,0,0,0,0,0,0,0,1
Sun 12 Apr 2020 05:00,0,0,0,4,1,3,2,2,0,0,3
Sun 12 Apr 2020 06:00,2,0,2,9,2,7,5,5,0,3,10
Sun 12 Apr 2020 07:00,0,0,0,25,11,14,12,8,4,9,5
Sun 12 Apr 2020 08:00,0,0,0,19,7,12,10,8,2,12,8
Sun 12 Apr 2020 09:00,2,2,0,14,10,4,4,3,1,2,8
Sun 12 Apr 2020 10:00,0,0,0,15,3,12,4,4,0,6,5
Sun 12 Apr 2020 11:00,0,0,0,26,8,18,1,1,0,5,3
Sun 12 Apr 2020 12:00,6,4,2,26,13,13,8,7,1,13,7
Sun 12 Apr 2020 13:00,4,1,3,41,18,23,22,18,4,20,13
Sun 12 Apr 2020 14:00,0,0,0,53,22,31,25,19,6,11,18
Sun 12 Apr 2020 15:00,10,7,3,49,17,32,14,10,4,10,9
Sun 12 Apr 2020 16:00,1,1,0,58,29,29,20,14,6,18,12
Sun 12 Apr 2020 17:00,4,1,3,76,32,44,26,19,7,16,25
Sun 12 Apr 2020 18:00,5,3,2,55,23,32,17,11,6,25,7
Sun 12 Apr 2020 19:00,6,3,3,69,37,32,29,20,9,25,18
Sun 12 Apr 2020 20:00,1,0,1,61,34,27,16,8,8,16,6
Sun 12 Apr 2020 21:00,2,0,2,35,19,16,15,10,5,12,5
Sun 12 Apr 2020 22:00,0,0,0,21,12,9,9,8,1,5,1
Sun 12 Apr 2020 23:00,1,0,1,12,9,3,4,3,1,3,2
Mon 13 Apr 2020 00:00,0,0,0,1,0,1,0,0,0,4,1
Mon 13 Apr 2020 01:00,0,0,0,3,1,2,1,0,1,1,0
Mon 13 Apr 2020 02:00,0,0,0,1,0,1,0,0,0,1,0
Mon 13 Apr 2020 03:00,0,0,0,4,4,0,0,0,0,2,0
Mon 13 Apr 2020 04:00,0,0,0,5,5,0,2,2,0,0,2
Mon 13 Apr 2020 05:00,0,0,0,6,1,5,0,0,0,0,5
Mon 13 Apr 2020 06:00,0,0,0,9,2,7,7,7,0,2,12
Mon 13 Apr 2020 07:00,1,1,0,26,16,10,11,8,3,4,9
Mon 13 Apr 2020 08:00,0,0,0,24,7,17,8,8,0,5,8
Mon 13 Apr 2020 09:00,4,1,3,40,24,16,7,6,1,12,13
Mon 13 Apr 2020 10:00,1,1,0,41,17,24,11,7,4,17,14
Mon 13 Apr 2020 11:00,1,0,1,74,37,37,8,7,1,14,8
Mon 13 Apr 2020 12:00,3,2,1,62,27,35,13,10,3,17,16
Mon 13 Apr 2020 13:00,17,11,6,89,36,53,34,16,18,48,17
Mon 13 Apr 2020 14:00,8,3,5,77,35,42,23,16,7,33,38
Mon 13 Apr 2020 15:00,3,1,2,97,49,48,27,14,13,23,32
Mon 13 Apr 2020 16:00,7,3,4,77,36,41,24,15,9,28,35
Mon 13 Apr 2020 17:00,1,1,0,104,46,58,17,8,9,41,27
Mon 13 Apr 2020 18:00,7,1,6,103,48,55,41,28,13,27,25
Mon 13 Apr 2020 19:00,3,2,1,80,35,45,34,19,15,24,17
Mon 13 Apr 2020 20:00,5,2,3,55,33,22,23,13,10,17,17
Mon 13 Apr 2020 21:00,3,2,1,34,21,13,16,10,6,11,4
Mon 13 Apr 2020 22:00,1,0,1,14,8,6,5,3,2,9,10
Mon 13 Apr 2020 23:00,0,0,0,5,3,2,4,1,3,2,2
Tue 14 Apr 2020 00:00,1,1,0,8,6,2,0,0,0,2,2
Tue 14 Apr 2020 01:00,0,0,0,1,1,0,0,0,0,0,1
Tue 14 Apr 2020 02:00,0,0,0,2,1,1,1,0,1,0,0
Tue 14 Apr 2020 03:00,0,0,0,3,3,0,1,1,0,0,0
Tue 14 Apr 2020 04:00,0,0,0,5,2,3,2,2,0,1,2
Tue 14 Apr 2020 05:00,1,0,1,15,3,12,6,5,1,0,5
Tue 14 Apr 2020 06:00,2,1,1,39,11,28,17,17,0,5,22
Tue 14 Apr 2020 07:00,2,1,1,79,30,49,25,15,10,11,50
Tue 14 Apr 2020 08:00,3,0,3,107,44,63,36,33,3,19,65
Tue 14 Apr 2020 09:00,5,4,1,68,27,41,9,8,1,4,24
Tue 14 Apr 2020 10:00,4,2,2,48,16,32,11,9,2,22,16
Tue 14 Apr 2020 11:00,3,1,2,70,25,45,12,7,5,25,21
Tue 14 Apr 2020 12:00,2,1,1,112,49,63,23,16,7,27,29
Tue 14 Apr 2020 13:00,7,3,4,106,48,58,30,20,10,24,20
Tue 14 Apr 2020 14:00,14,10,4,108,52,56,24,16,8,32,32
Tue 14 Apr 2020 15:00,8,4,4,95,45,50,27,12,15,61,27
Tue 14 Apr 2020 16:00,11,3,8,144,70,74,38,21,17,73,49
Tue 14 Apr 2020 17:00,5,4,1,169,76,93,29,17,12,77,30
Tue 14 Apr 2020 18:00,15,10,5,139,76,63,31,24,7,56,33
Tue 14 Apr 2020 19:00,4,1,3,117,63,54,34,26,8,45,21
Tue 14 Apr 2020 20:00,5,3,2,78,40,38,20,12,8,27,21
Tue 14 Apr 2020 21:00,1,0,1,28,15,13,17,10,7,21,8
Tue 14 Apr 2020 22:00,2,2,0,14,9,5,12,5,7,5,4
Tue 14 Apr 2020 23:00,0,0,0,10,4,6,2,1,1,9,3
Wed 15 Apr 2020 00:00,0,0,0,3,3,0,0,0,0,2,2
Wed 15 Apr 2020 01:00,0,0,0,3,1,2,0,0,0,0,1
Wed 15 Apr 2020 02:00,2,0,2,1,1,0,2,1,1,0,0
Wed 15 Apr 2020 03:00,0,0,0,3,3,0,1,1,0,0,0
Wed 15 Apr 2020 04:00,0,0,0,3,1,2,2,2,0,1,1
Wed 15 Apr 2020 05:00,1,0,1,10,3,7,3,2,1,0,4
Wed 15 Apr 2020 06:00,2,1,1,37,14,23,9,8,1,5,29
Wed 15 Apr 2020 07:00,1,0,1,77,31,46,28,22,6,9,45
Wed 15 Apr 2020 08:00,5,2,3,122,45,77,38,32,6,20,68
Wed 15 Apr 2020 09:00,5,2,3,57,19,38,15,14,1,17,17
Wed 15 Apr 2020 10:00,1,1,0,51,20,31,18,13,5,16,21
Wed 15 Apr 2020 11:00,6,3,3,71,30,41,13,11,2,23,15
Wed 15 Apr 2020 12:00,9,7,2,72,44,28,26,20,6,29,23
Wed 15 Apr 2020 13:00,7,6,1,102,56,46,35,25,10,49,27
Wed 15 Apr 2020 14:00,10,6,4,95,41,54,27,18,9,52,47
Wed 15 Apr 2020 15:00,10,6,4,112,40,72,32,25,7,49,38
Wed 15 Apr 2020 16:00,4,1,3,148,67,81,31,18,13,67,15
Wed 15 Apr 2020 17:00,11,6,5,167,95,72,34,16,18,84,33
Wed 15 Apr 2020 18:00,8,4,4,168,80,88,38,21,17,68,48
Wed 15 Apr 2020 19:00,6,5,1,124,60,64,18,12,6,37,28
Wed 15 Apr 2020 20:00,4,2,2,81,49,32,29,14,15,26,26
Wed 15 Apr 2020 21:00,1,1,0,38,28,10,10,7,3,25,9
Wed 15 Apr 2020 22:00,2,2,0,23,14,9,7,3,4,16,5
Wed 15 Apr 2020 23:00,4,1,3,9,3,6,6,2,4,2,4
Thu 16 Apr 2020 00:00,1,0,1,5,2,3,1,1,0,2,1
Thu 16 Apr 2020 01:00,0,0,0,2,1,1,1,0,1,0,1
Thu 16 Apr 2020 02:00,0,0,0,1,1,0,0,0,0,0,0
Thu 16 Apr 2020 03:00,0,0,0,3,3,0,0,0,0,0,0
Thu 16 Apr 2020 04:00,1,0,1,5,3,2,2,2,0,0,2
Thu 16 Apr 2020 05:00,1,0,1,16,4,12,7,6,1,1,5
Thu 16 Apr 2020 06:00,2,1,1,23,10,13,18,18,0,6,29
Thu 16 Apr 2020 07:00,2,1,1,90,35,55,32,25,7,9,35
Thu 16 Apr 2020 08:00,3,2,1,92,29,63,40,34,6,16,53
Thu 16 Apr 2020 09:00,3,3,0,51,19,32,9,8,1,10,24
Thu 16 Apr 2020 10:00,4,1,3,49,15,34,15,11,4,17,27
Thu 16 Apr 2020 11:00,3,2,1,50,15,35,10,8,2,33,27
Thu 16 Apr 2020 12:00,4,4,0,83,40,43,19,14,5,28,19
Thu 16 Apr 2020 13:00,9,7,2,92,50,42,39,26,13,45,20
Thu 16 Apr 2020 14:00,6,4,2,74,36,38,33,16,17,46,37
Thu 16 Apr 2020 15:00,6,6,0,111,53,58,26,21,5,69,28
Thu 16 Apr 2020 16:00,3,1,2,140,70,70,36,22,14,71,24
Thu 16 Apr 2020 17:00,11,6,5,177,76,101,41,25,16,80,41
Thu 16 Apr 2020 18:00,9,4,5,140,64,76,40,30,10,48,30
Thu 16 Apr 2020 19:00,12,5,7,114,53,61,42,21,21,31,27
Thu 16 Apr 2020 20:00,5,2,3,87,38,49,21,15,6,23,13
Thu 16 Apr 2020 21:00,1,1,0,48,30,18,14,11,3,25,14
Thu 16 Apr 2020 22:00,1,0,1,19,14,5,8,2,6,12,2
Thu 16 Apr 2020 23:00,1,1,0,9,6,3,2,1,1,5,1
Fri 17 Apr 2020 00:00,0,0,0,4,2,2,0,0,0,7,1
Fri 17 Apr 2020 01:00,1,0,1,2,1,1,0,0,0,0,2
Fri 17 Apr 2020 02:00,1,0,1,2,2,0,0,0,0,0,0
Fri 17 Apr 2020 03:00,0,0,0,2,1,1,2,2,0,0,1
Fri 17 Apr 2020 04:00,0,0,0,5,2,3,0,0,0,1,1
Fri 17 Apr 2020 05:00,0,0,0,16,5,11,5,4,1,3,4
Fri 17 Apr 2020 06:00,1,1,0,37,13,24,17,17,0,8,27
Fri 17 Apr 2020 07:00,1,0,1,86,30,56,25,20,5,6,45
Fri 17 Apr 2020 08:00,5,2,3,106,39,67,33,32,1,22,58
Fri 17 Apr 2020 09:00,6,4,2,56,23,33,17,16,1,9,22
Fri 17 Apr 2020 10:00,6,3,3,63,22,41,16,13,3,21,21
Fri 17 Apr 2020 11:00,4,2,2,89,40,49,21,10,11,20,28
Fri 17 Apr 2020 12:00,4,2,2,85,44,41,23,16,7,34,35
Fri 17 Apr 2020 13:00,7,2,5,106,50,56,36,25,11,34,46
Fri 17 Apr 2020 14:00,4,3,1,107,47,60,33,17,16,41,33
Fri 17 Apr 2020 15:00,12,9,3,91,46,45,17,12,5,58,28
Fri 17 Apr 2020 16:00,14,6,8,106,46,60,24,14,10,50,26
Fri 17 Apr 2020 17:00,9,4,5,128,67,61,35,27,8,66,42
Fri 17 Apr 2020 18:00,7,4,3,108,51,57,32,25,7,64,39
Fri 17 Apr 2020 19:00,12,9,3,97,53,44,18,12,6,34,16
Fri 17 Apr 2020 20:00,5,4,1,88,43,45,25,16,9,24,19
Fri 17 Apr 2020 21:00,4,2,2,45,23,22,16,10,6,25,20
Fri 17 Apr 2020 22:00,3,2,1,35,19,16,11,6,5,13,13
Fri 17 Apr 2020 23:00,0,0,0,15,12,3,5,3,2,8,5
Sat 18 Apr 2020 00:00,0,0,0,6,1,5,1,1,0,2,1
Sat 18 Apr 2020 01:00,1,0,1,4,4,0,1,1,0,0,0
Sat 18 Apr 2020 02:00,1,0,1,2,0,2,1,0,1,1,1
Sat 18 Apr 2020 03:00,0,0,0,2,2,0,0,0,0,1,1
Sat 18 Apr 2020 04:00,0,0,0,3,1,2,0,0,0,0,1
Sat 18 Apr 2020 05:00,2,0,2,3,1,2,2,1,1,1,2
Sat 18 Apr 2020 06:00,3,0,3,17,6,11,7,6,1,2,6
Sat 18 Apr 2020 07:00,0,0,0,34,19,15,8,5,3,3,13
Sat 18 Apr 2020 08:00,0,0,0,28,12,16,13,12,1,4,16
Sat 18 Apr 2020 09:00,2,1,1,30,11,19,6,4,2,10,12
Sat 18 Apr 2020 10:00,2,1,1,51,29,22,15,14,1,10,8
Sat 18 Apr 2020 11:00,2,2,0,65,26,39,13,10,3,22,12
Sat 18 Apr 2020 12:00,4,3,1,75,40,35,23,14,9,25,22
Sat 18 Apr 2020 13:00,4,2,2,65,30,35,15,10,5,30,24
Sat 18 Apr 2020 14:00,7,5,2,81,38,43,36,24,12,30,33
Sat 18 Apr 2020 15:00,4,3,1,94,52,42,34,21,13,38,23
Sat 18 Apr 2020 16:00,4,4,0,105,41,64,27,18,9,29,31
Sat 18 Apr 2020 17:00,4,4,0,106,46,60,32,23,9,37,22
Sat 18 Apr 2020 18:00,9,4,5,114,56,58,33,23,10,32,25
Sat 18 Apr 2020 19:00,2,1,1,61,35,26,22,19,3,37,19
Sat 18 Apr 2020 20:00,5,3,2,54,30,24,19,12,7,27,17
Sat 18 Apr 2020 21:00,5,3,2,42,22,20,14,7,7,10,8
Sat 18 Apr 2020 22:00,3,3,0,27,17,10,8,6,2,22,3
Sat 18 Apr 2020 23:00,1,0,1,10,6,4,5,3,2,7,4
Sun 19 Apr 2020 00:00,0,0,0,7,6,1,0,0,0,2,2
Sun 19 Apr 2020 01:00,0,0,0,2,2,0,0,0,0,0,0
Sun 19 Apr 2020 02:00,0,0,0,3,1,2,0,0,0,0,1
Sun 19 Apr 2020 03:00,1,0,1,3,3,0,0,0,0,0,0
Sun 19 Apr 2020 04:00,0,0,0,2,0,2,0,0,0,0,1
Sun 19 Apr 2020 05:00,0,0,0,5,1,4,3,3,0,0,1
Sun 19 Apr 2020 06:00,2,0,2,15,6,9,4,4,0,2,6
Sun 19 Apr 2020 07:00,0,0,0,21,6,15,13,7,6,7,9
Sun 19 Apr 2020 08:00,0,0,0,31,15,16,11,8,3,3,5
Sun 19 Apr 2020 09:00,1,1,0,26,16,10,9,7,2,11,6
Sun 19 Apr 2020 10:00,4,2,2,45,21,24,12,8,4,18,16
Sun 19 Apr 2020 11:00,8,3,5,73,27,46,16,10,6,21,29
Sun 19 Apr 2020 12:00,4,2,2,105,46,59,16,13,3,24,35
Sun 19 Apr 2020 13:00,9,2,7,105,51,54,43,28,15,32,31
Sun 19 Apr 2020 14:00,8,3,5,117,59,58,27,18,9,60,27
Sun 19 Apr 2020 15:00,7,1,6,128,53,75,40,29,11,27,40
Sun 19 Apr 2020 16:00,4,3,1,133,70,63,42,27,15,37,48
Sun 19 Apr 2020 17:00,4,2,2,109,43,66,46,20,26,51,44
Sun 19 Apr 2020 18:00,3,2,1,138,65,73,37,26,11,48,25
Sun 19 Apr 2020 19:00,2,0,2,88,38,50,33,27,6,23,28
Sun 19 Apr 2020 20:00,8,3,5,74,32,42,30,22,8,17,20
Sun 19 Apr 2020 21:00,3,1,2,42,26,16,16,7,9,20,16
Sun 19 Apr 2020 22:00,4,3,1,17,9,8,12,9,3,10,9
Sun 19 Apr 2020 23:00,3,2,1,7,5,2,3,2,1,10,1
Mon 20 Apr 2020 00:00,0,0,0,2,0,2,0,0,0,1,2
Mon 20 Apr 2020 01:00,0,0,0,2,2,0,1,0,1,0,1
Mon 20 Apr 2020 02:00,0,0,0,1,1,0,0,0,0,1,3
Mon 20 Apr 2020 03:00,0,0,0,1,1,0,1,1,0,1,1
Mon 20 Apr 2020 04:00,0,0,0,7,1,6,1,1,0,1,1
Mon 20 Apr 2020 05:00,1,0,1,11,4,7,4,4,0,1,10
Mon 20 Apr 2020 06:00,3,3,0,30,8,22,15,15,0,8,20
Mon 20 Apr 2020 07:00,3,1,2,84,39,45,30,23,7,10,45
Mon 20 Apr 2020 08:00,3,2,1,119,45,74,44,41,3,16,49
Mon 20 Apr 2020 09:00,3,2,1,61,17,44,13,10,3,11,23
Mon 20 Apr 2020 10:00,7,7,0,62,21,41,11,7,4,17,17
Mon 20 Apr 2020 11:00,4,3,1,58,22,36,12,8,4,18,15
Mon 20 Apr 2020 12:00,4,3,1,66,32,34,25,14,11,25,23
Mon 20 Apr 2020 13:00,4,2,2,89,35,54,34,31,3,41,28
Mon 20 Apr 2020 14:00,6,3,3,86,38,48,33,17,16,35,25
Mon 20 Apr 2020 15:00,6,3,3,101,49,52,20,13,7,53,32
Mon 20 Apr 2020 16:00,10,6,4,119,65,54,37,22,15,57,39
Mon 20 Apr 2020 17:00,8,3,5,137,59,78,39,29,10,64,30
Mon 20 Apr 2020 18:00,12,11,1,141,52,89,44,29,15,72,38
Mon 20 Apr 2020 19:00,3,1,2,119,57,62,37,28,9,33,27
Mon 20 Apr 2020 20:00,4,2,2,60,33,27,28,21,7,23,18
Mon 20 Apr 2020 21:00,5,2,3,30,18,12,15,10,5,24,5
Mon 20 Apr 2020 22:00,2,1,1,30,23,7,6,4,2,4,7
Mon 20 Apr 2020 23:00,1,1,0,10,5,5,1,1,0,6,3
Tue 21 Apr 2020 00:00,0,0,0,7,4,3,0,0,0,0,1
Tue 21 Apr 2020 01:00,0,0,0,2,2,0,0,0,0,0,1
Tue 21 Apr 2020 02:00,1,0,1,0,0,0,0,0,0,0,0
Tue 21 Apr 2020 03:00,0,0,0,1,1,0,1,1,0,1,1
Tue 21 Apr 2020 04:00,0,0,0,8,3,5,1,1,0,3,2
Tue 21 Apr 2020 05:00,1,0,1,14,4,10,4,3,1,3,8
Tue 21 Apr 2020 06:00,0,0,0,33,9,24,19,18,1,10,30
Tue 21 Apr 2020 07:00,2,1,1,84,28,56,39,31,8,9,48
Tue 21 Apr 2020 08:00,2,2,0,103,34,69,36,31,5,23,48
Tue 21 Apr 2020 09:00,6,3,3,64,26,38,17,14,3,16,39
Tue 21 Apr 2020 10:00,4,2,2,50,12,38,20,15,5,22,21
Tue 21 Apr 2020 11:00,5,3,2,61,30,31,14,10,4,22,23
Tue 21 Apr 2020 12:00,5,2,3,95,48,47,29,22,7,23,25
Tue 21 Apr 2020 13:00,7,4,3,82,45,37,30,22,8,32,28
Tue 21 Apr 2020 14:00,8,4,4,81,41,40,24,16,8,38,33
Tue 21 Apr 2020 15:00,6,4,2,86,42,44,31,23,8,45,29
Tue 21 Apr 2020 16:00,18,12,6,155,65,90,40,18,22,76,33
Tue 21 Apr 2020 17:00,3,2,1,198,98,100,50,25,25,81,41
Tue 21 Apr 2020 18:00,3,3,0,166,79,87,49,27,22,68,36
Tue 21 Apr 2020 19:00,6,4,2,117,57,60,34,18,16,39,34
Tue 21 Apr 2020 20:00,2,0,2,68,38,30,30,24,6,28,24
Tue 21 Apr 2020 21:00,2,0,2,31,21,10,10,9,1,21,8
Tue 21 Apr 2020 22:00,3,3,0,23,16,7,19,12,7,13,16
Tue 21 Apr 2020 23:00,0,0,0,6,4,2,3,0,3,9,3
Wed 22 Apr 2020 00:00,2,0,2,7,2,5,0,0,0,6,4
Wed 22 Apr 2020 01:00,1,0,1,1,0,1,1,0,1,1,0
Wed 22 Apr 2020 02:00,1,1,0,2,1,1,0,0,0,1,0
Wed 22 Apr 2020 03:00,0,0,0,2,2,0,1,1,0,0,0
Wed 22 Apr 2020 04:00,0,0,0,5,2,3,0,0,0,1,1
Wed 22 Apr 2020 05:00,2,0,2,18,4,14,4,3,1,0,8
Wed 22 Apr 2020 06:00,0,0,0,34,14,20,13,13,0,12,27
Wed 22 Apr 2020 07:00,2,1,1,82,33,49,30,22,8,13,69
Wed 22 Apr 2020 08:00,5,3,2,119,40,79,40,33,7,22,68
Wed 22 Apr 2020 09:00,5,4,1,59,25,34,21,19,2,16,27
Wed 22 Apr 2020 10:00,1,1,0,39,17,22,13,11,2,16,16
Wed 22 Apr 2020 11:00,7,2,5,56,26,30,16,15,1,17,20
Wed 22 Apr 2020 12:00,3,1,2,80,35,45,15,11,4,32,23
Wed 22 Apr 2020 13:00,2,1,1,90,36,54,28,19,9,44,25
Wed 22 Apr 2020 14:00,10,6,4,66,32,34,25,20,5,51,36
Wed 22 Apr 2020 15:00,4,1,3,103,54,49,29,23,6,52,45
Wed 22 Apr 2020 16:00,7,6,1,129,66,63,32,17,15,72,36
Wed 22 Apr 2020 17:00,12,9,3,175,88,87,45,32,13,83,33
Wed 22 Apr 2020 18:00,2,1,1,155,73,82,54,35,19,81,29
Wed 22 Apr 2020 19:00,9,3,6,165,87,78,35,18,17,45,31
Wed 22 Apr 2020 20:00,18,13,5,95,45,50,18,11,7,23,18
Wed 22 Apr 2020 21:00,7,5,2,42,27,15,15,10,5,16,15
Wed 22 Apr 2020 22:00,5,1,4,20,15,5,8,5,3,16,10
Wed 22 Apr 2020 23:00,2,0,2,9,4,5,4,1,3,11,5
Thu 23 Apr 2020 00:00,0,0,0,6,5,1,3,2,1,3,4
Thu 23 Apr 2020 01:00,0,0,0,3,3,0,2,1,1,2,2
Thu 23 Apr 2020 02:00,0,0,0,0,0,0,1,0,1,0,0
Thu 23 Apr 2020 03:00,0,0,0,2,2,0,2,1,1,0,0
Thu 23 Apr 2020 04:00,0,0,0,9,3,6,0,0,0,0,2
Thu 23 Apr 2020 05:00,1,0,1,15,3,12,4,3,1,1,3
Thu 23 Apr 2020 06:00,0,0,0,39,10,29,19,18,1,8,22
Thu 23 Apr 2020 07:00,0,0,0,88,36,52,32,26,6,10,63
Thu 23 Apr 2020 08:00,1,1,0,116,49,67,30,27,3,20,61
Thu 23 Apr 2020 09:00,6,6,0,64,22,42,16,16,0,18,35
Thu 23 Apr 2020 10:00,4,3,1,63,20,43,12,10,2,19,25
Thu 23 Apr 2020 11:00,10,5,5,65,22,43,18,14,4,16,17
Thu 23 Apr 2020 12:00,4,2,2,82,43,39,35,18,17,34,43
Thu 23 Apr 2020 13:00,8,7,1,120,46,74,42,28,14,40,30
Thu 23 Apr 2020 14:00,10,7,3,102,52,50,47,31,16,67,53
Thu 23 Apr 2020 15:00,4,4,0,107,54,53,36,21,15,54,44
Thu 23 Apr 2020 16:00,11,4,7,131,57,74,48,34,14,84,39
Thu 23 Apr 2020 17:00,5,3,2,176,87,89,50,26,24,66,42
Thu 23 Apr 2020 18:00,9,5,4,181,94,87,54,34,20,58,46
Thu 23 Apr 2020 19:00,6,2,4,122,57,65,31,24,7,47,37
Thu 23 Apr 2020 20:00,3,1,2,91,45,46,26,20,6,38,30
Thu 23 Apr 2020 21:00,3,2,1,40,22,18,31,16,15,20,14
Thu 23 Apr 2020 22:00,7,3,4,33,23,10,6,2,4,13,15
Thu 23 Apr 2020 23:00,2,0,2,12,8,4,4,2,2,9,5
Fri 24 Apr 2020 00:00,1,1,0,5,1,4,2,1,1,9,4
Fri 24 Apr 2020 01:00,0,0,0,4,3,1,0,0,0,0,1
Fri 24 Apr 2020 02:00,0,0,0,1,1,0,0,0,0,0,0
Fri 24 Apr 2020 03:00,0,0,0,0,0,0,0,0,0,0,0
Fri 24 Apr 2020 04:00,0,0,0,9,4,5,1,1,0,1,3
Fri 24 Apr 2020 05:00,1,0,1,16,4,12,4,4,0,2,4
Fri 24 Apr 2020 06:00,0,0,0,35,11,24,13,13,0,8,23
Fri 24 Apr 2020 07:00,1,1,0,96,30,66,32,23,9,17,38
Fri 24 Apr 2020 08:00,3,3,0,114,45,69,47,42,5,17,67
Fri 24 Apr 2020 09:00,10,8,2,76,33,43,22,17,5,13,30
Fri 24 Apr 2020 10:00,6,5,1,57,21,36,11,9,2,19,11
Fri 24 Apr 2020 11:00,3,2,1,69,28,41,17,8,9,24,30
Fri 24 Apr 2020 12:00,3,2,1,73,39,34,41,26,15,39,40
Fri 24 Apr 2020 13:00,10,8,2,123,48,75,25,17,8,53,41
Fri 24 Apr 2020 14:00,11,6,5,104,44,60,35,22,13,56,29
Fri 24 Apr 2020 15:00,11,9,2,98,42,56,29,19,10,51,24
Fri 24 Apr 2020 16:00,12,4,8,154,66,88,45,30,15,80,55
Fri 24 Apr 2020 17:00,7,3,4,173,90,83,46,36,10,68,64
Fri 24 Apr 2020 18:00,13,10,3,184,96,88,49,30,19,86,42
Fri 24 Apr 2020 19:00,8,7,1,138,76,62,36,27,9,39,52
Fri 24 Apr 2020 20:00,14,8,6,89,50,39,35,28,7,34,30
Fri 24 Apr 2020 21:00,3,2,1,60,36,24,25,16,9,28,23
Fri 24 Apr 2020 22:00,1,1,0,39,25,14,9,7,2,24,6
Fri 24 Apr 2020 23:00,1,1,0,10,7,3,4,2,2,15,8
Sat 25 Apr 2020 00:00,0,0,0,10,5,5,2,1,1,2,5
Sat 25 Apr 2020 01:00,1,0,1,4,2,2,1,1,0,2,2
Sat 25 Apr 2020 02:00,1,0,1,4,1,3,2,2,0,1,2
Sat 25 Apr 2020 03:00,0,0,0,2,1,1,1,1,0,2,0
Sat 25 Apr 2020 04:00,2,2,0,3,0,3,0,0,0,2,2
Sat 25 Apr 2020 05:00,0,0,0,12,5,7,6,5,1,3,3
Sat 25 Apr 2020 06:00,3,0,3,18,4,14,7,6,1,6,8
Sat 25 Apr 2020 07:00,0,0,0,38,15,23,14,8,6,4,10
Sat 25 Apr 2020 08:00,2,1,1,29,12,17,13,12,1,10,19
Sat 25 Apr 2020 09:00,6,3,3,38,17,21,13,7,6,23,19
Sat 25 Apr 2020 10:00,3,1,2,54,18,36,18,15,3,21,30
Sat 25 Apr 2020 11:00,5,4,1,80,31,49,29,18,11,36,31
Sat 25 Apr 2020 12:00,5,3,2,129,51,78,43,33,10,47,35
Sat 25 Apr 2020 13:00,7,3,4,180,85,95,51,37,14,67,48
Sat 25 Apr 2020 14:00,25,18,7,162,74,88,39,29,10,80,51
Sat 25 Apr 2020 15:00,14,11,3,166,75,91,51,27,24,56,45
Sat 25 Apr 2020 16:00,18,11,7,160,76,84,32,18,14,61,61
Sat 25 Apr 2020 17:00,4,3,1,152,77,75,42,29,13,38,49
Sat 25 Apr 2020 18:00,5,4,1,133,62,71,41,30,11,59,44
Sat 25 Apr 2020 19:00,3,1,2,110,65,45,41,26,15,43,40
Sat 25 Apr 2020 20:00,6,3,3,76,35,41,26,15,11,35,34
Sat 25 Apr 2020 21:00,9,2,7,59,31,28,18,10,8,28,20
Sat 25 Apr 2020 22:00,2,1,1,29,15,14,16,11,5,20,20
Sat 25 Apr 2020 23:00,6,3,3,22,10,12,6,3,3,7,1
Sun 26 Apr 2020 00:00,0,0,0,8,4,4,4,4,0,9,2
Sun 26 Apr 2020 01:00,0,0,0,4,2,2,1,1,0,1,2
Sun 26 Apr 2020 02:00,0,0,0,1,0,1,1,0,1,1,0
Sun 26 Apr 2020 03:00,0,0,0,3,2,1,0,0,0,0,1
Sun 26 Apr 2020 04:00,0,0,0,2,0,2,0,0,0,0,1
Sun 26 Apr 2020 05:00,0,0,0,4,1,3,2,1,1,1,3
Sun 26 Apr 2020 06:00,1,0,1,17,5,12,5,5,0,1,8
Sun 26 Apr 2020 07:00,3,3,0,28,12,16,10,8,2,9,8
Sun 26 Apr 2020 08:00,0,0,0,42,20,22,15,11,4,9,11
Sun 26 Apr 2020 09:00,3,1,2,39,23,16,14,9,5,14,18
Sun 26 Apr 2020 10:00,1,0,1,55,20,35,8,6,2,17,16
Sun 26 Apr 2020 11:00,3,3,0,61,28,33,23,18,5,19,28
Sun 26 Apr 2020 12:00,8,7,1,98,30,68,19,10,9,27,14
Sun 26 Apr 2020 13:00,9,6,3,81,41,40,35,23,12,37,42
Sun 26 Apr 2020 14:00,6,2,4,114,51,63,19,10,9,49,23
Sun 26 Apr 2020 15:00,5,3,2,91,35,56,36,25,11,37,41
Sun 26 Apr 2020 16:00,5,4,1,108,51,57,36,23,13,39,59
Sun 26 Apr 2020 17:00,13,9,4,86,44,42,28,19,9,36,30
Sun 26 Apr 2020 18:00,7,2,5,95,57,38,33,21,12,30,39
Sun 26 Apr 2020 19:00,6,4,2,73,40,33,27,13,14,32,33
Sun 26 Apr 2020 20:00,5,4,1,73,36,37,23,15,8,21,12
Sun 26 Apr 2020 21:00,1,0,1,38,22,16,10,4,6,15,17
Sun 26 Apr 2020 22:00,0,0,0,25,12,13,12,7,5,12,6
Sun 26 Apr 2020 23:00,0,0,0,3,1,2,2,1,1,8,2
Mon 27 Apr 2020 00:00,0,0,0,1,0,1,1,1,0,1,1
Mon 27 Apr 2020 01:00,2,0,2,1,1,0,0,0,0,0,1
Mon 27 Apr 2020 02:00,0,0,0,3,2,1,1,0,1,0,0
Mon 27 Apr 2020 03:00,0,0,0,0,0,0,1,1,0,2,0
Mon 27 Apr 2020 04:00,0,0,0,5,2,3,2,2,0,1,1
Mon 27 Apr 2020 05:00,1,0,1,13,6,7,5,5,0,2,8
Mon 27 Apr 2020 06:00,1,1,0,37,10,27,17,17,0,8,27
Mon 27 Apr 2020 07:00,2,0,2,92,37,55,32,25,7,16,53
Mon 27 Apr 2020 08:00,4,2,2,120,49,71,52,48,4,21,58
Mon 27 Apr 2020 09:00,3,2,1,64,18,46,11,10,1,21,23
Mon 27 Apr 2020 10:00,1,1,0,65,25,40,17,10,7,23,20
Mon 27 Apr 2020 11:00,7,5,2,65,36,29,17,10,7,11,15
Mon 27 Apr 2020 12:00,6,3,3,75,34,41,30,18,12,27,29
Mon 27 Apr 2020 13:00,4,1,3,101,45,56,36,18,18,40,34
Mon 27 Apr 2020 14:00,6,2,4,99,45,54,41,25,16,51,31
Mon 27 Apr 2020 15:00,13,8,5,96,50,46,39,23,16,52,44
Mon 27 Apr 2020 16:00,14,10,4,123,60,63,36,21,15,71,56
Mon 27 Apr 2020 17:00,10,5,5,158,86,72,41,27,14,89,48
Mon 27 Apr 2020 18:00,11,6,5,151,69,82,50,37,13,86,38
Mon 27 Apr 2020 19:00,7,1,6,124,70,54,34,21,13,45,29
Mon 27 Apr 2020 20:00,8,6,2,100,50,50,20,12,8,28,23
Mon 27 Apr 2020 21:00,5,2,3,31,14,17,19,11,8,23,16
Mon 27 Apr 2020 22:00,1,1,0,26,18,8,12,10,2,12,11
Mon 27 Apr 2020 23:00,0,0,0,7,5,2,5,1,4,5,3
Tue 28 Apr 2020 00:00,2,0,2,7,4,3,1,1,0,3,4
Tue 28 Apr 2020 01:00,0,0,0,1,0,1,0,0,0,2,0
Tue 28 Apr 2020 02:00,0,0,0,1,1,0,0,0,0,0,0
Tue 28 Apr 2020 03:00,0,0,0,2,1,1,1,1,0,0,0
Tue 28 Apr 2020 04:00,0,0,0,7,2,5,1,1,0,1,1
Tue 28 Apr 2020 05:00,0,0,0,14,7,7,5,5,0,2,8
Tue 28 Apr 2020 06:00,0,0,0,41,13,28,18,17,1,10,27
Tue 28 Apr 2020 07:00,2,2,0,100,45,55,44,35,9,11,52
Tue 28 Apr 2020 08:00,4,3,1,117,46,71,40,37,3,21,77
Tue 28 Apr 2020 09:00,4,2,2,78,26,52,18,14,4,15,46
Tue 28 Apr 2020 10:00,7,3,4,54,15,39,10,9,1,17,26
Tue 28 Apr 2020 11:00,4,2,2,70,31,39,16,12,4,19,27
Tue 28 Apr 2020 12:00,7,4,3,70,30,40,32,23,9,28,27
Tue 28 Apr 2020 13:00,5,3,2,93,38,55,26,16,10,47,38
Tue 28 Apr 2020 14:00,8,4,4,78,45,33,30,21,9,51,33
Tue 28 Apr 2020 15:00,7,4,3,89,48,41,32,23,9,53,46
Tue 28 Apr 2020 16:00,10,6,4,128,69,59,44,24,20,84,32
Tue 28 Apr 2020 17:00,12,7,5,172,84,88,46,31,15,76,44
Tue 28 Apr 2020 18:00,5,3,2,160,74,86,46,29,17,69,55
Tue 28 Apr 2020 19:00,8,6,2,112,52,60,30,23,7,57,42
Tue 28 Apr 2020 20:00,3,2,1,79,47,32,32,21,11,40,27
Tue 28 Apr 2020 21:00,1,1,0,29,15,14,18,9,9,22,14
Tue 28 Apr 2020 22:00,1,1,0,21,14,7,9,5,4,16,8
Tue 28 Apr 2020 23:00,0,0,0,5,2,3,1,1,0,15,4
Wed 29 Apr 2020 00:00,0,0,0,5,3,2,0,0,0,2,4
Wed 29 Apr 2020 01:00,0,0,0,4,2,2,0,0,0,1,1
Wed 29 Apr 2020 02:00,0,0,0,0,0,0,1,0,1,0,0
Wed 29 Apr 2020 03:00,0,0,0,2,2,0,1,1,0,1,0
Wed 29 Apr 2020 04:00,0,0,0,7,4,3,1,1,0,1,2
Wed 29 Apr 2020 05:00,2,1,1,11,4,7,5,4,1,2,6
Wed 29 Apr 2020 06:00,0,0,0,36,10,26,19,19,0,10,27
Wed 29 Apr 2020 07:00,1,0,1,83,32,51,27,19,8,12,50
Wed 29 Apr 2020 08:00,1,1,0,116,46,70,47,44,3,20,64
Wed 29 Apr 2020 09:00,5,3,2,54,19,35,23,18,5,10,35
Wed 29 Apr 2020 10:00,0,0,0,27,9,18,10,7,3,11,13
Wed 29 Apr 2020 11:00,5,3,2,31,13,18,12,9,3,11,12
Wed 29 Apr 2020 12:00,0,0,0,43,25,18,14,10,4,15,17
Wed 29 Apr 2020 13:00,3,2,1,64,20,44,16,12,4,26,26
Wed 29 Apr 2020 14:00,3,2,1,44,25,19,19,13,6,31,28
Wed 29 Apr 2020 15:00,4,3,1,84,40,44,35,28,7,43,21
Wed 29 Apr 2020 16:00,8,7,1,114,61,53,38,23,15,57,40
Wed 29 Apr 2020 17:00,9,4,5,138,62,76,31,21,10,81,36
Wed 29 Apr 2020 18:00,9,6,3,152,73,79,40,25,15,82,40
Wed 29 Apr 2020 19:00,7,4,3,104,53,51,31,22,9,50,23
Wed 29 Apr 2020 20:00,4,1,3,53,29,24,21,13,8,24,21
Wed 29 Apr 2020 21:00,5,3,2,22,16,6,7,5,2,25,10
Wed 29 Apr 2020 22:00,1,0,1,19,15,4,5,3,2,10,5
Wed 29 Apr 2020 23:00,0,0,0,6,3,3,2,1,1,3,1
Thu 30 Apr 2020 00:00,0,0,0,6,1,5,2,1,1,3,2
Thu 30 Apr 2020 01:00,0,0,0,1,0,1,0,0,0,0,0
Thu 30 Apr 2020 02:00,0,0,0,3,3,0,0,0,0,0,0
Thu 30 Apr 2020 03:00,0,0,0,1,1,0,0,0,0,0,0
Thu 30 Apr 2020 04:00,0,0,0,8,2,6,1,1,0,1,2
Thu 30 Apr 2020 05:00,1,1,0,14,5,9,4,3,1,3,4
Thu 30 Apr 2020 06:00,0,0,0,33,10,23,15,15,0,7,21
Thu 30 Apr 2020 07:00,3,1,2,71,21,50,28,22,6,4,38
Thu 30 Apr 2020 08:00,1,0,1,77,26,51,28,27,1,7,48
Thu 30 Apr 2020 09:00,2,1,1,61,23,38,13,9,4,16,21
Thu 30 Apr 2020 10:00,0,0,0,43,16,27,9,8,1,12,23
Thu 30 Apr 2020 11:00,1,0,1,51,18,33,13,11,2,11,13
Thu 30 Apr 2020 12:00,3,3,0,64,30,34,28,17,11,21,15
Thu 30 Apr 2020 13:00,5,4,1,54,32,22,17,13,4,25,26
Thu 30 Apr 2020 14:00,7,5,2,57,21,36,17,12,5,39,19
Thu 30 Apr 2020 15:00,2,2,0,60,32,28,22,10,12,43,27
Thu 30 Apr 2020 16:00,9,5,4,85,39,46,34,21,13,46,19
Thu 30 Apr 2020 17:00,9,3,6,110,58,52,42,23,19,67,26
Thu 30 Apr 2020 18:00,6,1,5,135,54,81,40,29,11,53,33
Thu 30 Apr 2020 19:00,9,5,4,93,51,42,27,18,9,42,18
Thu 30 Apr 2020 20:00,6,3,3,82,46,36,27,17,10,29,16
Thu 30 Apr 2020 21:00,1,1,0,42,24,18,15,8,7,21,20
Thu 30 Apr 2020 22:00,1,0,1,20,16,4,8,7,1,15,8
Thu 30 Apr 2020 23:00,1,1,0,11,5,6,4,2,2,5,3
Fri 1 May 2020 00:00,0,0,0,5,2,3,1,1,0,5,3
Fri 1 May 2020 01:00,2,0,2,2,1,1,0,0,0,2,2
Fri 1 May 2020 02:00,0,0,0,2,2,0,0,0,0,2,0
Fri 1 May 2020 03:00,0,0,0,1,1,0,3,1,2,1,0
Fri 1 May 2020 04:00,0,0,0,9,4,5,0,0,0,2,2
Fri 1 May 2020 05:00,1,1,0,11,5,6,6,6,0,4,3
Fri 1 May 2020 06:00,1,0,1,40,14,26,10,10,0,8,26
Fri 1 May 2020 07:00,1,0,1,84,32,52,34,27,7,15,41
Fri 1 May 2020 08:00,3,2,1,109,41,68,43,41,2,14,60
Fri 1 May 2020 09:00,2,1,1,71,22,49,22,16,6,15,28
Fri 1 May 2020 10:00,2,1,1,71,28,43,13,10,3,21,20
Fri 1 May 2020 11:00,2,2,0,77,38,39,17,13,4,28,26
Fri 1 May 2020 12:00,10,7,3,102,47,55,33,19,14,42,49
Fri 1 May 2020 13:00,10,5,5,95,47,48,42,26,16,52,47
Fri 1 May 2020 14:00,12,4,8,84,37,47,32,20,12,52,40
Fri 1 May 2020 15:00,10,3,7,75,36,39,30,20,10,35,31
Fri 1 May 2020 16:00,8,3,5,108,50,58,33,18,15,57,24
Fri 1 May 2020 17:00,6,5,1,140,64,76,51,39,12,74,43
Fri 1 May 2020 18:00,3,0,3,129,69,60,27,20,7,54,33
Fri 1 May 2020 19:00,8,2,6,92,37,55,25,19,6,45,25
Fri 1 May 2020 20:00,2,1,1,104,48,56,33,22,11,28,20
Fri 1 May 2020 21:00,6,2,4,55,29,26,25,14,11,20,21
Fri 1 May 2020 22:00,4,2,2,36,26,10,11,7,4,27,5
Fri 1 May 2020 23:00,1,0,1,17,10,7,3,3,0,14,3
Sat 2 May 2020 00:00,0,0,0,7,4,3,1,1,0,1,3
Sat 2 May 2020 01:00,1,1,0,5,1,4,1,1,0,4,1
Sat 2 May 2020 02:00,1,0,1,0,0,0,0,0,0,1,4
Sat 2 May 2020 03:00,0,0,0,2,1,1,0,0,0,0,1
Sat 2 May 2020 04:00,0,0,0,1,0,1,0,0,0,1,0
Sat 2 May 2020 05:00,1,0,1,11,2,9,4,3,1,6,1
Sat 2 May 2020 06:00,2,1,1,18,3,15,6,4,2,8,8
Sat 2 May 2020 07:00,2,2,0,26,7,19,8,6,2,16,14
Sat 2 May 2020 08:00,1,1,0,26,9,17,18,15,3,9,20
Sat 2 May 2020 09:00,5,4,1,57,24,33,19,15,4,26,24
Sat 2 May 2020 10:00,4,4,0,85,40,45,25,18,7,25,29
Sat 2 May 2020 11:00,8,7,1,92,35,57,30,20,10,29,19
Sat 2 May 2020 12:00,5,3,2,113,43,70,25,18,7,47,29
Sat 2 May 2020 13:00,8,5,3,166,86,80,40,28,12,57,51
Sat 2 May 2020 14:00,10,6,4,162,60,102,53,31,22,60,73
Sat 2 May 2020 15:00,7,5,2,179,83,96,48,38,10,55,66
Sat 2 May 2020 16:00,18,13,5,166,83,83,55,31,24,69,64
Sat 2 May 2020 17:00,11,4,7,153,59,94,58,32,26,75,72
Sat 2 May 2020 18:00,6,3,3,161,77,84,39,28,11,55,68
Sat 2 May 2020 19:00,7,4,3,125,69,56,28,17,11,40,48
Sat 2 May 2020 20:00,10,5,5,81,45,36,31,19,12,41,23
Sat 2 May 2020 21:00,5,1,4,50,26,24,24,16,8,24,15
Sat 2 May 2020 22:00,2,2,0,31,18,13,8,6,2,27,11
Sat 2 May 2020 23:00,1,1,0,17,11,6,8,5,3,12,9
Sun 3 May 2020 00:00,1,0,1,8,5,3,3,2,1,6,1
Sun 3 May 2020 01:00,0,0,0,3,1,2,1,1,0,3,2
Sun 3 May 2020 02:00,0,0,0,2,1,1,2,0,2,2,0
Sun 3 May 2020 03:00,1,0,1,0,0,0,1,0,1,0,0
Sun 3 May 2020 04:00,0,0,0,2,0,2,0,0,0,0,1
Sun 3 May 2020 05:00,2,1,1,4,1,3,1,1,0,1,1
Sun 3 May 2020 06:00,0,0,0,13,6,7,3,3,0,6,6
Sun 3 May 2020 07:00,0,0,0,27,10,17,9,6,3,9,6
Sun 3 May 2020 08:00,2,2,0,35,11,24,19,17,2,19,14
Sun 3 May 2020 09:00,3,2,1,58,29,29,16,14,2,16,19
Sun 3 May 2020 10:00,8,6,2,83,30,53,18,11,7,30,19
Sun 3 May 2020 11:00,5,2,3,121,40,81,21,11,10,39,33
Sun 3 May 2020 12:00,9,7,2,144,61,83,48,33,15,66,50
Sun 3 May 2020 13:00,12,4,8,193,80,113,63,34,29,56,50
Sun 3 May 2020 14:00,17,11,6,203,94,109,70,43,27,79,87
Sun 3 May 2020 15:00,7,3,4,169,73,96,68,44,24,89,69
Sun 3 May 2020 16:00,13,5,8,178,75,103,51,31,20,50,63
Sun 3 May 2020 17:00,18,11,7,167,93,74,50,35,15,72,60
Sun 3 May 2020 18:00,12,8,4,126,67,59,59,32,27,48,70
Sun 3 May 2020 19:00,2,1,1,117,63,54,35,24,11,49,49
Sun 3 May 2020 20:00,6,4,2,93,45,48,27,18,9,46,36
Sun 3 May 2020 21:00,1,1,0,61,26,35,22,13,9,21,19
Sun 3 May 2020 22:00,12,6,6,45,28,17,11,8,3,18,13
Sun 3 May 2020 23:00,1,1,0,10,7,3,5,3,2,9,5
Mon 4 May 2020 00:00,1,1,0,5,4,1,2,2,0,6,4
Mon 4 May 2020 01:00,2,0,2,5,2,3,2,2,0,2,0
Mon 4 May 2020 02:00,0,0,0,1,0,1,2,0,2,1,0
Mon 4 May 2020 03:00,0,0,0,1,0,1,0,0,0,1,0
Mon 4 May 2020 04:00,0,0,0,5,4,1,1,0,1,2,1
Mon 4 May 2020 05:00,0,0,0,8,0,8,2,1,1,0,4
Mon 4 May 2020 06:00,2,0,2,12,3,9,8,6,2,6,14
Mon 4 May 2020 07:00,1,1,0,40,15,25,20,19,1,12,18
Mon 4 May 2020 08:00,1,1,0,44,16,28,24,21,3,14,15
Mon 4 May 2020 09:00,4,2,2,66,25,41,24,15,9,20,14
Mon 4 May 2020 10:00,13,7,6,96,36,60,30,21,9,39,31
Mon 4 May 2020 11:00,15,8,7,148,65,83,34,24,10,40,25
Mon 4 May 2020 12:00,5,4,1,161,70,91,42,26,16,42,42
Mon 4 May 2020 13:00,15,10,5,184,78,106,73,47,26,79,51
Mon 4 May 2020 14:00,13,9,4,190,74,116,66,36,30,59,85
Mon 4 May 2020 15:00,11,4,7,183,67,116,63,39,24,72,62
Mon 4 May 2020 16:00,17,12,5,183,92,91,46,21,25,101,57
Mon 4 May 2020 17:00,8,0,8,194,104,90,45,30,15,65,86
Mon 4 May 2020 18:00,2,2,0,147,82,65,56,31,25,53,66
Mon 4 May 2020 19:00,8,8,0,126,53,73,55,33,22,43,45
Mon 4 May 2020 20:00,8,5,3,66,33,33,32,19,13,47,32
Mon 4 May 2020 21:00,3,2,1,62,36,26,26,21,5,20,16
Mon 4 May 2020 22:00,2,2,0,19,7,12,15,7,8,8,11
Mon 4 May 2020 23:00,1,1,0,8,3,5,5,3,2,5,9
Tue 5 May 2020 00:00,2,0,2,3,1,2,3,3,0,4,2
Tue 5 May 2020 01:00,0,0,0,4,4,0,0,0,0,1,1
Tue 5 May 2020 02:00,0,0,0,3,2,1,1,0,1,1,0
Tue 5 May 2020 03:00,0,0,0,1,1,0,1,1,0,0,3
Tue 5 May 2020 04:00,0,0,0,9,4,5,1,1,0,2,2
Tue 5 May 2020 05:00,0,0,0,9,2,7,7,6,1,4,11
Tue 5 May 2020 06:00,0,0,0,34,9,25,16,16,0,13,31
Tue 5 May 2020 07:00,2,1,1,94,42,52,35,29,6,12,55
Tue 5 May 2020 08:00,9,7,2,129,52,77,52,45,7,28,80
Tue 5 May 2020 09:00,3,2,1,77,31,46,13,12,1,20,41
Tue 5 May 2020 10:00,2,1,1,74,36,38,26,19,7,29,27
Tue 5 May 2020 11:00,3,1,2,74,37,37,18,12,6,33,40
Tue 5 May 2020 12:00,5,5,0,81,34,47,25,14,11,44,39
Tue 5 May 2020 13:00,11,6,5,111,40,71,43,26,17,74,52
Tue 5 May 2020 14:00,17,11,6,125,44,81,50,26,24,77,53
Tue 5 May 2020 15:00,17,10,7,118,64,54,61,36,25,81,59
Tue 5 May 2020 16:00,10,5,5,146,58,88,51,31,20,88,42
Tue 5 May 2020 17:00,18,11,7,194,87,107,81,50,31,106,45
Tue 5 May 2020 18:00,14,8,6,184,91,93,53,34,19,87,73
Tue 5 May 2020 19:00,6,3,3,161,68,93,48,20,28,67,43
Tue 5 May 2020 20:00,6,2,4,119,63,56,37,24,13,57,16
Tue 5 May 2020 21:00,7,4,3,46,20,26,26,13,13,34,27
Tue 5 May 2020 22:00,1,1,0,34,25,9,13,7,6,17,10
Tue 5 May 2020 23:00,1,0,1,10,6,4,3,3,0,3,4
Wed 6 May 2020 00:00,,,,4,4,0,,,,,
Wed 6 May 2020 01:00,,,,2,0,2,,,,,
Wed 6 May 2020 02:00,,,,0,0,0,,,,,
Wed 6 May 2020 03:00,,,,2,2,0,,,,,
Wed 6 May 2020 04:00,,,,10,4,6,,,,,
Wed 6 May 2020 05:00,,,,9,3,6,0,0,0,,
Wed 6 May 2020 06:00,,,,47,11,36,,,,,
Wed 6 May 2020 07:00,,,,102,41,61,,,,,
Wed 6 May 2020 08:00,,,,141,59,82,,,,,
Wed 6 May 2020 09:00,,,,94,33,61,,,,,
Wed 6 May 2020 10:00,,,,64,21,43,,,,,
Wed 6 May 2020 11:00,,,,83,26,57,,,,,
Wed 6 May 2020 12:00,,,,129,46,83,,,,,
Wed 6 May 2020 13:00,,,,127,69,58,,,,,
Wed 6 May 2020 14:00,7,4,3,148,69,79,0,0,0,11,17
Wed 6 May 2020 15:00,11,8,3,117,44,73,60,42,18,111,48
Wed 6 May 2020 16:00,10,2,8,173,70,103,47,28,19,94,49
Wed 6 May 2020 17:00,20,9,11,205,98,107,64,36,28,102,74
Wed 6 May 2020 18:00,11,7,4,227,108,119,63,38,25,96,53
Wed 6 May 2020 19:00,11,4,7,182,96,86,64,43,21,48,60
Wed 6 May 2020 20:00,15,10,5,104,47,57,40,19,21,52,40
Wed 6 May 2020 21:00,6,4,2,58,39,19,33,18,15,24,12
Wed 6 May 2020 22:00,7,4,3,29,23,6,13,9,4,22,11
Wed 6 May 2020 23:00,0,0,0,16,6,10,2,1,1,6,7
Thu 7 May 2020 00:00,0,0,0,7,1,6,0,0,0,3,1
Thu 7 May 2020 01:00,0,0,0,3,2,1,0,0,0,4,0
Thu 7 May 2020 02:00,0,0,0,2,2,0,1,0,1,1,0
Thu 7 May 2020 03:00,0,0,0,1,1,0,2,2,0,0,1
Thu 7 May 2020 04:00,1,0,1,8,3,5,1,1,0,0,3
Thu 7 May 2020 05:00,0,0,0,17,4,13,4,3,1,5,5
Thu 7 May 2020 06:00,0,0,0,43,14,29,14,12,2,15,27
Thu 7 May 2020 07:00,3,2,1,94,39,55,34,25,9,16,56
Thu 7 May 2020 08:00,1,1,0,151,55,96,44,42,2,24,75
Thu 7 May 2020 09:00,2,1,1,94,37,57,26,22,4,23,35
Thu 7 May 2020 10:00,2,2,0,53,21,32,19,13,6,29,25
Thu 7 May 2020 11:00,4,3,1,72,24,48,22,17,5,30,42
Thu 7 May 2020 12:00,6,4,2,72,36,36,31,18,13,41,41
Thu 7 May 2020 13:00,5,4,1,105,40,65,35,30,5,43,37
Thu 7 May 2020 14:00,15,12,3,106,52,54,33,23,10,54,33
Thu 7 May 2020 15:00,4,3,1,117,59,58,37,24,13,72,32
Thu 7 May 2020 16:00,8,2,6,153,80,73,42,22,20,81,56
Thu 7 May 2020 17:00,15,9,6,173,72,101,63,48,15,106,56
Thu 7 May 2020 18:00,19,14,5,191,105,86,47,22,25,85,50
Thu 7 May 2020 19:00,7,3,4,222,94,128,41,31,10,67,55
Thu 7 May 2020 20:00,5,4,1,112,61,51,38,19,19,62,30
Thu 7 May 2020 21:00,3,3,0,85,47,38,18,9,9,40,23
Thu 7 May 2020 22:00,4,1,3,40,22,18,23,12,11,26,29
Thu 7 May 2020 23:00,3,1,2,22,12,10,7,6,1,14,10
Fri 8 May 2020 00:00,0,0,0,8,5,3,1,1,0,4,1
Fri 8 May 2020 01:00,1,1,0,6,4,2,1,0,1,4,3
Fri 8 May 2020 02:00,0,0,0,1,0,1,0,0,0,1,0
Fri 8 May 2020 03:00,0,0,0,2,1,1,1,1,0,2,1
Fri 8 May 2020 04:00,1,0,1,5,3,2,0,0,0,1,0
Fri 8 May 2020 05:00,0,0,0,14,3,11,8,7,1,3,4
Fri 8 May 2020 06:00,0,0,0,36,9,27,16,14,2,7,27
Fri 8 May 2020 07:00,2,2,0,113,46,67,37,24,13,21,50
Fri 8 May 2020 08:00,3,3,0,150,54,96,42,39,3,23,81
Fri 8 May 2020 09:00,7,5,2,83,24,59,25,22,3,19,45
Fri 8 May 2020 10:00,5,3,2,109,39,70,29,20,9,30,29
Fri 8 May 2020 11:00,7,3,4,106,41,65,44,27,17,52,42
Fri 8 May 2020 12:00,12,11,1,161,62,99,48,33,15,69,47
Fri 8 May 2020 13:00,12,4,8,177,79,98,63,31,32,73,46
Fri 8 May 2020 14:00,15,10,5,144,62,82,73,43,30,87,55
Fri 8 May 2020 15:00,13,6,7,136,55,81,64,34,30,107,53
Fri 8 May 2020 16:00,11,5,6,197,87,110,64,34,30,108,59
Fri 8 May 2020 17:00,10,6,4,229,103,126,80,47,33,112,58
Fri 8 May 2020 18:00,17,7,10,219,104,115,88,60,28,99,105
Fri 8 May 2020 19:00,13,5,8,205,111,94,45,27,18,71,70
Fri 8 May 2020 20:00,15,4,11,126,67,59,44,19,25,59,44
Fri 8 May 2020 21:00,9,7,2,73,40,33,21,13,8,34,29
Fri 8 May 2020 22:00,2,2,0,42,27,15,23,11,12,33,17
Fri 8 May 2020 23:00,0,0,0,25,17,8,4,2,2,17,7
Sat 9 May 2020 00:00,1,0,1,18,13,5,6,4,2,5,2
Sat 9 May 2020 01:00,0,0,0,9,5,4,2,1,1,2,2
Sat 9 May 2020 02:00,0,0,0,2,1,1,1,0,1,2,0
Sat 9 May 2020 03:00,1,0,1,5,2,3,0,0,0,3,2
Sat 9 May 2020 04:00,0,0,0,4,1,3,3,2,1,5,2
Sat 9 May 2020 05:00,0,0,0,9,2,7,3,3,0,11,3
Sat 9 May 2020 06:00,1,0,1,35,15,20,8,8,0,8,14
Sat 9 May 2020 07:00,2,1,1,44,19,25,16,13,3,18,19
Sat 9 May 2020 08:00,1,1,0,45,15,30,21,18,3,14,30
Sat 9 May 2020 09:00,4,4,0,78,32,46,24,17,7,46,38
Sat 9 May 2020 10:00,7,3,4,128,44,84,41,32,9,63,49
Sat 9 May 2020 11:00,11,7,4,198,75,123,68,38,30,99,50
Sat 9 May 2020 12:00,16,13,3,207,88,119,85,50,35,130,60
Sat 9 May 2020 13:00,22,16,6,264,84,180,88,59,29,149,93
Sat 9 May 2020 14:00,22,18,4,250,88,162,116,70,46,141,124
Sat 9 May 2020 15:00,23,12,11,270,127,143,107,45,62,136,103
Sat 9 May 2020 16:00,13,3,10,198,90,108,80,55,25,133,120
Sat 9 May 2020 17:00,19,6,13,210,124,86,73,39,34,116,135
Sat 9 May 2020 18:00,8,5,3,208,117,91,83,51,32,82,100
Sat 9 May 2020 19:00,6,2,4,196,100,96,66,40,26,67,87
Sat 9 May 2020 20:00,15,5,10,141,71,70,44,30,14,57,68
Sat 9 May 2020 21:00,10,4,6,110,60,50,39,25,14,45,27
Sat 9 May 2020 22:00,4,2,2,67,40,27,30,14,16,31,16
Sat 9 May 2020 23:00,1,0,1,20,14,6,10,7,3,16,9
Sun 10 May 2020 00:00,3,2,1,9,4,5,6,2,4,12,7
Sun 10 May 2020 01:00,3,2,1,10,4,6,0,0,0,5,6
Sun 10 May 2020 02:00,3,2,1,4,1,3,6,4,2,1,2
Sun 10 May 2020 03:00,0,0,0,1,1,0,2,1,1,0,0
Sun 10 May 2020 04:00,0,0,0,2,2,0,0,0,0,2,1
Sun 10 May 2020 05:00,0,0,0,6,3,3,0,0,0,0,2
Sun 10 May 2020 06:00,0,0,0,14,5,9,6,6,0,3,8
Sun 10 May 2020 07:00,0,0,0,26,10,16,12,9,3,17,12
Sun 10 May 2020 08:00,2,2,0,44,9,35,19,14,5,10,12
Sun 10 May 2020 09:00,3,1,2,48,27,21,18,12,6,19,17
Sun 10 May 2020 10:00,3,0,3,82,34,48,25,12,13,25,29
Sun 10 May 2020 11:00,5,2,3,86,38,48,29,16,13,25,32
Sun 10 May 2020 12:00,8,6,2,87,36,51,43,33,10,36,39
Sun 10 May 2020 13:00,11,5,6,100,48,52,23,13,10,18,36
Sun 10 May 2020 14:00,3,1,2,70,29,41,20,14,6,50,21
Sun 10 May 2020 15:00,13,5,8,77,39,38,43,33,10,35,38
Sun 10 May 2020 16:00,9,8,1,87,40,47,36,31,5,48,21
Sun 10 May 2020 17:00,8,3,5,90,42,48,23,15,8,37,33
Sun 10 May 2020 18:00,6,3,3,82,41,41,31,20,11,26,38
Sun 10 May 2020 19:00,6,3,3,65,39,26,22,18,4,34,28
Sun 10 May 2020 20:00,2,0,2,61,32,29,28,19,9,32,18
Sun 10 May 2020 21:00,6,3,3,57,28,29,14,9,5,27,21
Sun 10 May 2020 22:00,4,2,2,25,19,6,12,6,6,19,6
Sun 10 May 2020 23:00,0,0,0,10,5,5,2,0,2,9,2
Mon 11 May 2020 00:00,1,1,0,4,3,1,0,0,0,2,2
Mon 11 May 2020 01:00,0,0,0,2,2,0,1,0,1,0,1
Mon 11 May 2020 02:00,0,0,0,0,0,0,0,0,0,0,0
Mon 11 May 2020 03:00,0,0,0,1,1,0,1,1,0,1,0
Mon 11 May 2020 04:00,0,0,0,12,6,6,1,1,0,1,1
Mon 11 May 2020 05:00,0,0,0,10,5,5,4,4,0,1,7
Mon 11 May 2020 06:00,1,1,0,42,11,31,12,12,0,5,28
Mon 11 May 2020 07:00,4,3,1,88,34,54,39,32,7,21,57
Mon 11 May 2020 08:00,6,4,2,133,44,89,47,42,5,18,56
Mon 11 May 2020 09:00,2,0,2,73,19,54,25,22,3,10,27
Mon 11 May 2020 10:00,3,1,2,46,13,33,5,2,3,16,24
Mon 11 May 2020 11:00,7,5,2,57,26,31,14,13,1,28,34
Mon 11 May 2020 12:00,11,4,7,82,38,44,23,14,9,37,24
Mon 11 May 2020 13:00,8,2,6,87,37,50,31,22,9,50,45
Mon 11 May 2020 14:00,8,4,4,107,43,64,25,12,13,47,40
Mon 11 May 2020 15:00,6,3,3,113,57,56,37,21,16,59,44
Mon 11 May 2020 16:00,13,9,4,133,65,68,55,32,23,79,51
Mon 11 May 2020 17:00,7,6,1,181,98,83,46,33,13,96,47
Mon 11 May 2020 18:00,14,11,3,194,93,101,56,30,26,96,53
Mon 11 May 2020 19:00,7,3,4,141,66,75,45,24,21,55,40
Mon 11 May 2020 20:00,6,4,2,104,60,44,36,25,11,38,24
Mon 11 May 2020 21:00,4,2,2,39,16,23,18,14,4,37,9
Mon 11 May 2020 22:00,1,1,0,23,8,15,9,5,4,17,11
Mon 11 May 2020 23:00,1,1,0,16,11,5,2,2,0,5,5
Tue 12 May 2020 00:00,1,1,0,8,2,6,0,0,0,5,3
Tue 12 May 2020 01:00,0,0,0,7,3,4,0,0,0,1,0
Tue 12 May 2020 02:00,0,0,0,0,0,0,0,0,0,1,1
Tue 12 May 2020 03:00,0,0,0,2,1,1,1,1,0,0,0
Tue 12 May 2020 04:00,0,0,0,5,3,2,1,1,0,2,4
Tue 12 May 2020 05:00,1,1,0,18,4,14,5,4,1,5,5
Tue 12 May 2020 06:00,0,0,0,36,10,26,18,18,0,10,34
Tue 12 May 2020 07:00,2,2,0,110,46,64,34,26,8,16,51
Tue 12 May 2020 08:00,11,8,3,136,58,78,50,46,4,22,74
Tue 12 May 2020 09:00,4,2,2,82,18,64,23,20,3,16,41
Tue 12 May 2020 10:00,3,2,1,72,43,29,28,20,8,25,31
Tue 12 May 2020 11:00,10,6,4,79,38,41,31,23,8,39,35
Tue 12 May 2020 12:00,6,3,3,97,32,65,33,23,10,33,47
Tue 12 May 2020 13:00,6,1,5,107,51,56,34,17,17,54,50
Tue 12 May 2020 14:00,6,3,3,94,44,50,36,20,16,46,60
Tue 12 May 2020 15:00,9,5,4,90,46,44,41,26,15,72,32
Tue 12 May 2020 16:00,10,8,2,140,66,74,37,17,20,85,41
Tue 12 May 2020 17:00,11,8,3,186,91,95,53,37,16,115,79
Tue 12 May 2020 18:00,17,7,10,182,97,85,46,22,24,108,28
Tue 12 May 2020 19:00,6,4,2,145,59,86,35,19,16,65,30
Tue 12 May 2020 20:00,6,1,5,101,56,45,39,21,18,52,41
Tue 12 May 2020 21:00,7,7,0,73,37,36,23,13,10,26,20
Tue 12 May 2020 22:00,1,1,0,25,18,7,17,7,10,20,8
Tue 12 May 2020 23:00,0,0,0,10,4,6,6,4,2,12,2
Wed 13 May 2020 00:00,0,0,0,10,3,7,1,1,0,5,3
Wed 13 May 2020 01:00,0,0,0,7,7,0,3,0,3,4,1
Wed 13 May 2020 02:00,0,0,0,0,0,0,1,0,1,1,0
Wed 13 May 2020 03:00,0,0,0,2,1,1,1,1,0,0,1
Wed 13 May 2020 04:00,0,0,0,7,4,3,1,1,0,2,4
Wed 13 May 2020 05:00,2,1,1,13,2,11,7,6,1,3,5
Wed 13 May 2020 06:00,0,0,0,41,14,27,21,19,2,10,28
Wed 13 May 2020 07:00,3,2,1,102,39,63,37,28,9,29,72
Wed 13 May 2020 08:00,9,7,2,127,44,83,50,45,5,15,80
Wed 13 May 2020 09:00,5,4,1,81,24,57,24,22,2,21,56
Wed 13 May 2020 10:00,4,2,2,46,19,27,19,11,8,18,44
Wed 13 May 2020 11:00,3,2,1,78,22,56,21,15,6,50,25
Wed 13 May 2020 12:00,14,6,8,90,25,65,33,24,9,51,36
Wed 13 May 2020 13:00,12,6,6,121,38,83,39,23,16,44,35
Wed 13 May 2020 14:00,7,2,5,99,49,50,38,21,17,50,56
Wed 13 May 2020 15:00,15,7,8,123,41,82,36,23,13,57,35
Wed 13 May 2020 16:00,13,8,5,152,77,75,44,22,22,88,42
Wed 13 May 2020 17:00,14,9,5,210,113,97,69,46,23,120,51
Wed 13 May 2020 18:00,13,10,3,191,93,98,61,37,24,125,45
Wed 13 May 2020 19:00,11,5,6,137,73,64,54,29,25,68,46
Wed 13 May 2020 20:00,7,5,2,48,26,22,48,38,10,48,45
Wed 13 May 2020 21:00,3,0,3,4,2,2,17,5,12,49,32
Wed 13 May 2020 22:00,1,0,1,6,4,2,12,9,3,21,10
Wed 13 May 2020 23:00,0,0,0,17,6,11,5,2,3,6,6
Thu 14 May 2020 00:00,0,0,0,5,2,3,1,0,1,3,1
Thu 14 May 2020 01:00,0,0,0,2,2,0,0,0,0,0,1
Thu 14 May 2020 02:00,0,0,0,3,1,2,2,0,2,0,0
Thu 14 May 2020 03:00,1,0,1,1,1,0,2,1,1,0,0
Thu 14 May 2020 04:00,0,0,0,7,1,6,3,1,2,3,1
Thu 14 May 2020 05:00,3,1,2,12,4,8,4,4,0,2,5
Thu 14 May 2020 06:00,0,0,0,37,13,24,18,17,1,8,30
Thu 14 May 2020 07:00,5,4,1,109,41,68,33,24,9,25,59
Thu 14 May 2020 08:00,5,4,1,127,47,80,47,47,0,24,82
Thu 14 May 2020 09:00,1,1,0,127,31,96,20,19,1,12,41
Thu 14 May 2020 10:00,1,1,0,117,32,85,27,20,7,24,27
Thu 14 May 2020 11:00,3,2,1,99,31,68,34,23,11,36,27
Thu 14 May 2020 12:00,6,3,3,156,37,119,48,27,21,54,25
Thu 14 May 2020 13:00,14,7,7,160,46,114,52,35,17,87,58
Thu 14 May 2020 14:00,8,4,4,139,55,84,41,28,13,83,68
Thu 14 May 2020 15:00,6,4,2,171,78,93,42,23,19,93,66
Thu 14 May 2020 16:00,19,15,4,175,86,89,56,31,25,133,56
Thu 14 May 2020 17:00,17,11,6,229,115,114,66,40,26,126,88
Thu 14 May 2020 18:00,14,8,6,249,128,121,84,57,27,95,87
Thu 14 May 2020 19:00,9,2,7,182,78,104,59,32,27,65,85
Thu 14 May 2020 20:00,6,4,2,127,68,59,63,28,35,52,31
Thu 14 May 2020 21:00,7,2,5,65,22,43,35,16,19,35,29
Thu 14 May 2020 22:00,3,1,2,34,24,10,14,6,8,21,10
Thu 14 May 2020 23:00,0,0,0,20,7,13,9,6,3,11,8
Fri 15 May 2020 00:00,0,0,0,13,8,5,2,0,2,8,1
Fri 15 May 2020 01:00,0,0,0,4,1,3,2,0,2,1,2
Fri 15 May 2020 02:00,1,1,0,1,1,0,0,0,0,0,0
Fri 15 May 2020 03:00,0,0,0,1,1,0,1,0,1,2,0
Fri 15 May 2020 04:00,2,2,0,6,3,3,1,1,0,3,4
Fri 15 May 2020 05:00,3,2,1,12,4,8,4,4,0,2,8
Fri 15 May 2020 06:00,0,0,0,40,11,29,12,11,1,12,34
Fri 15 May 2020 07:00,1,1,0,97,28,69,49,38,11,19,64
Fri 15 May 2020 08:00,8,7,1,144,51,93,48,44,4,22,93
Fri 15 May 2020 09:00,6,2,4,86,32,54,30,27,3,12,37
Fri 15 May 2020 10:00,13,10,3,73,31,42,18,15,3,17,31
Fri 15 May 2020 11:00,6,3,3,80,32,48,27,22,5,31,33
Fri 15 May 2020 12:00,3,1,2,106,40,66,27,19,8,57,46
Fri 15 May 2020 13:00,5,1,4,139,61,78,38,26,12,68,54
Fri 15 May 2020 14:00,7,5,2,114,52,62,45,18,27,64,55
Fri 15 May 2020 15:00,11,7,4,116,52,64,37,18,19,61,37
Fri 15 May 2020 16:00,16,9,7,150,77,73,52,34,18,77,53
Fri 15 May 2020 17:00,14,7,7,186,96,90,55,37,18,128,76
Fri 15 May 2020 18:00,14,8,6,181,92,89,53,32,21,102,53
Fri 15 May 2020 19:00,11,7,4,140,75,65,48,31,17,61,28
Fri 15 May 2020 20:00,12,9,3,111,52,59,31,23,8,48,55
Fri 15 May 2020 21:00,5,2,3,80,37,43,36,23,13,28,25
Fri 15 May 2020 22:00,2,1,1,46,32,14,21,13,8,23,15
Fri 15 May 2020 23:00,1,0,1,23,10,13,9,6,3,12,11
Sat 16 May 2020 00:00,0,0,0,16,10,6,4,2,2,6,4
Sat 16 May 2020 01:00,1,0,1,9,3,6,3,1,2,5,2
Sat 16 May 2020 02:00,0,0,0,2,1,1,1,1,0,2,0
Sat 16 May 2020 03:00,0,0,0,3,2,1,0,0,0,0,0
Sat 16 May 2020 04:00,0,0,0,1,1,0,3,2,1,1,0
Sat 16 May 2020 05:00,0,0,0,13,2,11,6,6,0,6,8
Sat 16 May 2020 06:00,0,0,0,24,5,19,8,7,1,8,10
Sat 16 May 2020 07:00,1,1,0,53,20,33,14,14,0,16,23
Sat 16 May 2020 08:00,4,3,1,55,20,35,22,20,2,19,26
Sat 16 May 2020 09:00,3,2,1,71,26,45,27,20,7,38,30
Sat 16 May 2020 10:00,2,2,0,106,37,69,31,21,10,37,41
Sat 16 May 2020 11:00,9,7,2,124,53,71,65,42,23,68,61
Sat 16 May 2020 12:00,7,5,2,156,61,95,51,31,20,89,67
Sat 16 May 2020 13:00,13,7,6,223,93,130,101,60,41,80,67
Sat 16 May 2020 14:00,13,9,4,219,102,117,83,52,31,105,106
Sat 16 May 2020 15:00,9,7,2,270,113,157,79,56,23,100,121
Sat 16 May 2020 16:00,16,12,4,204,88,116,83,52,31,120,73
Sat 16 May 2020 17:00,14,9,5,205,108,97,60,36,24,77,95
Sat 16 May 2020 18:00,11,6,5,175,85,90,63,37,26,70,85
Sat 16 May 2020 19:00,11,3,8,139,70,69,44,28,16,48,61
Sat 16 May 2020 20:00,4,2,2,116,61,55,39,24,15,61,52
Sat 16 May 2020 21:00,5,0,5,74,37,37,29,18,11,32,39
Sat 16 May 2020 22:00,5,4,1,53,35,18,24,8,16,36,23
Sat 16 May 2020 23:00,2,1,1,21,11,10,7,5,2,21,11
Sun 17 May 2020 00:00,2,0,2,18,5,13,7,6,1,10,2
Sun 17 May 2020 01:00,0,0,0,12,10,2,1,1,0,5,2
Sun 17 May 2020 02:00,2,0,2,4,3,1,0,0,0,6,2
Sun 17 May 2020 03:00,0,0,0,0,0,0,1,1,0,1,0
Sun 17 May 2020 04:00,0,0,0,2,1,1,1,1,0,0,2
Sun 17 May 2020 05:00,0,0,0,8,4,4,1,1,0,4,3
Sun 17 May 2020 06:00,2,1,1,17,7,10,8,5,3,6,11
Sun 17 May 2020 07:00,1,1,0,32,11,21,11,8,3,18,10
Sun 17 May 2020 08:00,2,2,0,33,12,21,17,15,2,19,23
Sun 17 May 2020 09:00,9,5,4,58,19,39,34,21,13,26,32
Sun 17 May 2020 10:00,6,5,1,101,42,59,20,12,8,38,39
Sun 17 May 2020 11:00,10,3,7,97,35,62,40,27,13,65,32
Sun 17 May 2020 12:00,10,5,5,133,46,87,57,31,26,82,49
Sun 17 May 2020 13:00,15,10,5,176,74,102,74,39,35,77,68
Sun 17 May 2020 14:00,19,13,6,193,76,117,78,40,38,102,84
Sun 17 May 2020 15:00,12,8,4,190,72,118,86,60,26,103,83
Sun 17 May 2020 16:00,12,6,6,178,83,95,78,47,31,77,89
Sun 17 May 2020 17:00,6,4,2,142,70,72,64,43,21,71,84
Sun 17 May 2020 18:00,12,5,7,159,77,82,60,36,24,67,80
Sun 17 May 2020 19:00,10,3,7,114,54,60,47,25,22,53,50
Sun 17 May 2020 20:00,10,5,5,86,40,46,38,21,17,60,42
Sun 17 May 2020 21:00,3,3,0,68,36,32,27,14,13,22,19
Sun 17 May 2020 22:00,2,1,1,44,33,11,20,10,10,38,13
Sun 17 May 2020 23:00,1,0,1,8,5,3,4,2,2,15,6
Mon 18 May 2020 00:00,2,1,1,12,5,7,0,0,0,1,4
Mon 18 May 2020 01:00,1,1,0,3,3,0,0,0,0,2,1
Mon 18 May 2020 02:00,2,0,2,0,0,0,0,0,0,1,3
Mon 18 May 2020 03:00,0,0,0,2,2,0,1,1,0,1,0
Mon 18 May 2020 04:00,0,0,0,9,6,3,0,0,0,1,3
Mon 18 May 2020 05:00,1,0,1,12,4,8,4,4,0,4,12
Mon 18 May 2020 06:00,2,1,1,49,14,35,28,24,4,17,39
Mon 18 May 2020 07:00,6,5,1,113,44,69,53,44,9,21,72
Mon 18 May 2020 08:00,4,4,0,138,42,96,50,47,3,24,78
Mon 18 May 2020 09:00,1,1,0,73,19,54,31,28,3,12,36
Mon 18 May 2020 10:00,6,5,1,65,29,36,18,14,4,12,21
Mon 18 May 2020 11:00,8,3,5,83,31,52,15,12,3,28,31
Mon 18 May 2020 12:00,5,2,3,80,34,46,28,22,6,37,39
Mon 18 May 2020 13:00,3,1,2,94,37,57,42,34,8,40,37
Mon 18 May 2020 14:00,7,4,3,75,42,33,14,9,5,37,33
Mon 18 May 2020 15:00,2,2,0,91,43,48,29,15,14,61,14
Mon 18 May 2020 16:00,9,4,5,122,59,63,34,23,11,78,28
Mon 18 May 2020 17:00,7,4,3,193,91,102,55,29,26,105,49
Mon 18 May 2020 18:00,2,1,1,165,89,76,42,28,14,91,58
Mon 18 May 2020 19:00,9,2,7,133,65,68,34,20,14,50,35
Mon 18 May 2020 20:00,3,2,1,104,55,49,34,17,17,32,29
Mon 18 May 2020 21:00,8,5,3,72,26,46,21,13,8,32,16
Mon 18 May 2020 22:00,7,3,4,35,23,12,9,4,5,17,7
Mon 18 May 2020 23:00,2,0,2,17,10,7,5,3,2,9,14
Tue 19 May 2020 00:00,0,0,0,6,3,3,2,2,0,5,1
Tue 19 May 2020 01:00,1,0,1,7,5,2,2,0,2,1,5
Tue 19 May 2020 02:00,0,0,0,3,2,1,0,0,0,0,0
Tue 19 May 2020 03:00,0,0,0,4,2,2,1,1,0,0,0
Tue 19 May 2020 04:00,0,0,0,12,5,7,0,0,0,0,4
Tue 19 May 2020 05:00,1,0,1,11,4,7,3,3,0,5,7
Tue 19 May 2020 06:00,1,1,0,56,14,42,32,30,2,12,49
Tue 19 May 2020 07:00,5,4,1,138,53,85,59,49,10,27,85
Tue 19 May 2020 08:00,3,3,0,154,53,101,52,52,0,22,89
Tue 19 May 2020 09:00,4,3,1,92,27,65,31,28,3,14,56
Tue 19 May 2020 10:00,7,4,3,66,22,44,29,20,9,23,35
Tue 19 May 2020 11:00,6,4,2,84,31,53,28,22,6,41,47
Tue 19 May 2020 12:00,5,2,3,137,52,85,36,24,12,57,36
Tue 19 May 2020 13:00,6,3,3,148,67,81,44,34,10,57,43
Tue 19 May 2020 14:00,18,13,5,148,55,93,60,38,22,74,44
Tue 19 May 2020 15:00,6,4,2,130,50,80,65,31,34,107,52
Tue 19 May 2020 16:00,10,7,3,215,104,111,83,52,31,139,71
Tue 19 May 2020 17:00,16,9,7,290,137,153,86,54,32,157,71
Tue 19 May 2020 18:00,15,10,5,281,137,144,87,59,28,116,77
Tue 19 May 2020 19:00,20,14,6,213,96,117,83,51,32,92,101
Tue 19 May 2020 20:00,8,3,5,170,83,87,54,22,32,44,71
Tue 19 May 2020 21:00,6,1,5,103,66,37,36,19,17,35,37
Tue 19 May 2020 22:00,3,2,1,42,30,12,21,12,9,27,21
Tue 19 May 2020 23:00,1,0,1,32,14,18,4,2,2,20,9
Wed 20 May 2020 00:00,0,0,0,11,6,5,1,1,0,3,2
Wed 20 May 2020 01:00,0,0,0,7,7,0,0,0,0,2,2
Wed 20 May 2020 02:00,0,0,0,3,2,1,0,0,0,1,0
Wed 20 May 2020 03:00,0,0,0,2,1,1,2,2,0,2,1
Wed 20 May 2020 04:00,0,0,0,7,3,4,3,3,0,4,5
Wed 20 May 2020 05:00,1,0,1,14,6,8,5,4,1,5,2
Wed 20 May 2020 06:00,4,4,0,65,12,53,48,42,6,13,63
Wed 20 May 2020 07:00,6,4,2,146,53,93,66,59,7,30,90
Wed 20 May 2020 08:00,2,2,0,176,63,113,70,65,5,32,107
Wed 20 May 2020 09:00,5,4,1,96,38,58,30,24,6,30,68
Wed 20 May 2020 10:00,6,3,3,97,30,67,35,20,15,52,38
Wed 20 May 2020 11:00,17,13,4,102,46,56,49,40,9,72,61
Wed 20 May 2020 12:00,30,18,12,178,62,116,70,39,31,109,73
Wed 20 May 2020 13:00,8,6,2,194,64,130,92,56,36,149,76
Wed 20 May 2020 14:00,18,8,10,183,78,105,55,38,17,129,89
Wed 20 May 2020 15:00,7,4,3,185,83,102,57,31,26,118,65
Wed 20 May 2020 16:00,24,16,8,241,128,113,65,33,32,159,110
Wed 20 May 2020 17:00,20,8,12,315,152,163,122,64,58,191,91
Wed 20 May 2020 18:00,16,9,7,328,145,183,125,70,55,143,97
Wed 20 May 2020 19:00,18,13,5,219,111,108,81,45,36,92,126
Wed 20 May 2020 20:00,19,10,9,190,113,77,77,46,31,45,63
Wed 20 May 2020 21:00,9,5,4,127,73,54,42,25,17,52,39
Wed 20 May 2020 22:00,9,6,3,65,44,21,20,9,11,32,18
Wed 20 May 2020 23:00,2,1,1,29,10,19,15,6,9,17,11
Thu 21 May 2020 00:00,1,0,1,13,8,5,2,2,0,7,4
Thu 21 May 2020 01:00,0,0,0,6,4,2,1,0,1,2,3
Thu 21 May 2020 02:00,0,0,0,1,1,0,0,0,0,3,0
Thu 21 May 2020 03:00,0,0,0,1,0,1,2,2,0,2,0
Thu 21 May 2020 04:00,2,1,1,9,2,7,0,0,0,2,2
Thu 21 May 2020 05:00,0,0,0,15,3,12,5,5,0,2,7
Thu 21 May 2020 06:00,3,3,0,59,11,48,37,35,2,19,43
Thu 21 May 2020 07:00,2,1,1,136,54,82,56,45,11,15,69
Thu 21 May 2020 08:00,5,5,0,140,48,92,67,64,3,26,108
Thu 21 May 2020 09:00,6,4,2,117,33,84,31,27,4,21,65
Thu 21 May 2020 10:00,13,10,3,75,28,47,30,22,8,34,42
Thu 21 May 2020 11:00,5,3,2,110,48,62,33,23,10,48,34
Thu 21 May 2020 12:00,7,6,1,143,53,90,38,24,14,55,66
Thu 21 May 2020 13:00,5,1,4,145,66,79,45,30,15,73,61
Thu 21 May 2020 14:00,17,14,3,142,66,76,67,43,24,76,67
Thu 21 May 2020 15:00,8,4,4,134,78,56,60,32,28,68,57
Thu 21 May 2020 16:00,13,6,7,203,111,92,55,32,23,126,60
Thu 21 May 2020 17:00,15,7,8,216,120,96,74,45,29,153,63
Thu 21 May 2020 18:00,7,6,1,176,87,89,76,48,28,110,43
Thu 21 May 2020 19:00,12,5,7,183,94,89,30,20,10,61,46
Thu 21 May 2020 20:00,4,1,3,95,42,53,61,32,29,51,48
Thu 21 May 2020 21:00,4,3,1,68,38,30,25,19,6,29,20
Thu 21 May 2020 22:00,2,1,1,32,17,15,13,5,8,30,15
Thu 21 May 2020 23:00,1,1,0,12,7,5,3,2,1,11,11
Fri 22 May 2020 00:00,0,0,0,10,2,8,1,1,0,4,3
Fri 22 May 2020 01:00,2,0,2,3,1,2,1,1,0,3,2
Fri 22 May 2020 02:00,0,0,0,5,1,4,1,0,1,2,1
Fri 22 May 2020 03:00,0,0,0,0,0,0,0,0,0,1,1
Fri 22 May 2020 04:00,0,0,0,7,3,4,1,1,0,0,2
Fri 22 May 2020 05:00,0,0,0,17,5,12,3,3,0,3,8
Fri 22 May 2020 06:00,3,3,0,51,9,42,36,32,4,10,41
Fri 22 May 2020 07:00,4,4,0,91,27,64,49,39,10,15,59
Fri 22 May 2020 08:00,6,6,0,114,27,87,56,52,4,19,73
Fri 22 May 2020 09:00,4,3,1,61,16,45,24,18,6,14,35
Fri 22 May 2020 10:00,7,6,1,60,17,43,14,11,3,20,21
Fri 22 May 2020 11:00,5,4,1,47,19,28,28,22,6,21,24
Fri 22 May 2020 12:00,11,5,6,80,37,43,30,23,7,33,22
Fri 22 May 2020 13:00,3,0,3,93,42,51,40,26,14,38,27
Fri 22 May 2020 14:00,6,4,2,84,40,44,28,18,10,49,25
Fri 22 May 2020 15:00,8,6,2,83,35,48,28,19,9,44,25
Fri 22 May 2020 16:00,5,4,1,90,47,43,43,21,22,74,38
Fri 22 May 2020 17:00,9,5,4,141,77,64,46,31,15,79,41
Fri 22 May 2020 18:00,5,4,1,133,64,69,49,32,17,66,33
Fri 22 May 2020 19:00,11,4,7,103,50,53,43,27,16,73,58
Fri 22 May 2020 20:00,6,2,4,87,43,44,44,21,23,41,37
Fri 22 May 2020 21:00,3,2,1,77,40,37,28,18,10,29,24
Fri 22 May 2020 22:00,7,5,2,42,29,13,25,13,12,24,15
Fri 22 May 2020 23:00,1,1,0,18,8,10,14,8,6,16,5
Sat 23 May 2020 00:00,0,0,0,14,9,5,1,1,0,2,2
Sat 23 May 2020 01:00,0,0,0,6,4,2,4,3,1,1,0
Sat 23 May 2020 02:00,0,0,0,2,2,0,3,2,1,2,4
Sat 23 May 2020 03:00,0,0,0,2,1,1,1,1,0,1,1
Sat 23 May 2020 04:00,0,0,0,3,1,2,0,0,0,1,2
Sat 23 May 2020 05:00,0,0,0,7,2,5,2,2,0,3,4
Sat 23 May 2020 06:00,0,0,0,20,7,13,13,12,1,10,12
Sat 23 May 2020 07:00,0,0,0,43,14,29,7,5,2,12,17
Sat 23 May 2020 08:00,3,2,1,47,16,31,15,15,0,8,16
Sat 23 May 2020 09:00,3,2,1,49,18,31,16,14,2,19,23
Sat 23 May 2020 10:00,12,2,10,69,37,32,19,12,7,19,17
Sat 23 May 2020 11:00,2,0,2,81,35,46,32,23,9,37,28
Sat 23 May 2020 12:00,4,3,1,79,25,54,34,25,9,42,40
Sat 23 May 2020 13:00,3,2,1,123,55,68,46,25,21,51,39
Sat 23 May 2020 14:00,5,3,2,109,41,68,50,29,21,46,51
Sat 23 May 2020 15:00,7,5,2,100,45,55,34,27,7,51,33
Sat 23 May 2020 16:00,12,6,6,98,51,47,40,24,16,70,53
Sat 23 May 2020 17:00,12,9,3,102,49,53,43,29,14,42,43
Sat 23 May 2020 18:00,12,7,5,113,62,51,39,28,11,60,48
Sat 23 May 2020 19:00,2,1,1,90,51,39,44,24,20,50,52
Sat 23 May 2020 20:00,7,5,2,87,43,44,21,12,9,36,28
Sat 23 May 2020 21:00,3,2,1,52,33,19,14,9,5,30,19
Sat 23 May 2020 22:00,3,2,1,46,30,16,11,5,6,11,10
Sat 23 May 2020 23:00,1,1,0,23,12,11,10,8,2,10,9
Sun 24 May 2020 00:00,1,0,1,17,8,9,4,3,1,9,4
Sun 24 May 2020 01:00,2,1,1,10,5,5,1,1,0,3,1
Sun 24 May 2020 02:00,1,1,0,4,0,4,0,0,0,3,1
Sun 24 May 2020 03:00,0,0,0,2,2,0,1,1,0,0,1
Sun 24 May 2020 04:00,0,0,0,3,1,2,0,0,0,1,0
Sun 24 May 2020 05:00,2,1,1,7,1,6,2,2,0,2,3
Sun 24 May 2020 06:00,1,0,1,11,2,9,10,9,1,8,12
Sun 24 May 2020 07:00,1,1,0,26,9,17,5,4,1,12,12
Sun 24 May 2020 08:00,0,0,0,39,10,29,17,16,1,16,15
Sun 24 May 2020 09:00,3,2,1,44,16,28,15,11,4,27,14
Sun 24 May 2020 10:00,7,5,2,101,40,61,39,24,15,27,21
Sun 24 May 2020 11:00,5,4,1,137,55,82,47,35,12,63,44
Sun 24 May 2020 12:00,21,13,8,172,69,103,64,36,28,88,65
Sun 24 May 2020 13:00,8,6,2,217,68,149,86,41,45,133,88
Sun 24 May 2020 14:00,18,14,4,279,98,181,84,60,24,138,94
Sun 24 May 2020 15:00,21,17,4,259,113,146,107,76,31,131,95
Sun 24 May 2020 16:00,14,7,7,248,115,133,95,45,50,139,107
Sun 24 May 2020 17:00,21,11,10,220,104,116,99,57,42,127,111
Sun 24 May 2020 18:00,14,2,12,235,127,108,80,45,35,81,117
Sun 24 May 2020 19:00,15,9,6,170,100,70,57,37,20,70,97
Sun 24 May 2020 20:00,18,9,9,158,78,80,62,40,22,70,78
Sun 24 May 2020 21:00,21,8,13,94,57,37,57,23,34,65,71
Sun 24 May 2020 22:00,8,3,5,57,32,25,30,15,15,39,18
Sun 24 May 2020 23:00,5,2,3,38,25,13,6,4,2,22,11
Mon 25 May 2020 00:00,0,0,0,13,10,3,4,4,0,6,9
Mon 25 May 2020 01:00,0,0,0,4,3,1,3,2,1,5,1
Mon 25 May 2020 02:00,0,0,0,3,0,3,0,0,0,1,0
Mon 25 May 2020 03:00,0,0,0,6,3,3,0,0,0,1,0
Mon 25 May 2020 04:00,1,0,1,6,3,3,1,1,0,0,2
Mon 25 May 2020 05:00,1,1,0,10,6,4,7,7,0,3,14
Mon 25 May 2020 06:00,2,2,0,80,18,62,51,48,3,14,59
Mon 25 May 2020 07:00,2,2,0,137,42,95,58,47,11,26,76
Mon 25 May 2020 08:00,5,4,1,157,51,106,74,70,4,31,96
Mon 25 May 2020 09:00,3,3,0,107,27,80,33,26,7,25,67
Mon 25 May 2020 10:00,5,3,2,91,33,58,21,17,4,37,37
Mon 25 May 2020 11:00,5,3,2,115,54,61,39,25,14,41,50
Mon 25 May 2020 12:00,10,7,3,166,66,100,51,37,14,72,54
Mon 25 May 2020 13:00,14,9,5,163,63,100,60,39,21,83,65
Mon 25 May 2020 14:00,16,11,5,167,62,105,76,52,24,103,48
Mon 25 May 2020 15:00,12,8,4,183,70,113,71,32,39,92,78
Mon 25 May 2020 16:00,18,8,10,178,96,82,77,37,40,129,93
Mon 25 May 2020 17:00,13,10,3,268,161,107,108,49,59,133,94
Mon 25 May 2020 18:00,10,6,4,223,116,107,85,53,32,116,74
Mon 25 May 2020 19:00,21,7,14,158,78,80,61,35,26,79,52
Mon 25 May 2020 20:00,13,5,8,103,53,50,53,28,25,53,38
Mon 25 May 2020 21:00,6,3,3,78,43,35,31,24,7,31,30
Mon 25 May 2020 22:00,7,6,1,41,21,20,20,12,8,28,12
Mon 25 May 2020 23:00,5,2,3,20,9,11,10,5,5,15,5
Tue 26 May 2020 00:00,0,0,0,15,9,6,2,1,1,4,3
Tue 26 May 2020 01:00,0,0,0,6,4,2,1,0,1,1,2
Tue 26 May 2020 02:00,0,0,0,1,0,1,0,0,0,0,1
Tue 26 May 2020 03:00,0,0,0,1,1,0,1,1,0,2,0
Tue 26 May 2020 04:00,0,0,0,9,3,6,0,0,0,1,2
Tue 26 May 2020 05:00,2,1,1,15,8,7,10,9,1,5,14
Tue 26 May 2020 06:00,3,2,1,86,20,66,70,61,9,19,64
Tue 26 May 2020 07:00,5,4,1,143,41,102,73,58,15,24,94
Tue 26 May 2020 08:00,5,5,0,178,59,119,60,59,1,25,115
Tue 26 May 2020 09:00,5,3,2,112,34,78,43,39,4,28,60
Tue 26 May 2020 10:00,12,6,6,99,28,71,32,18,14,35,45
Tue 26 May 2020 11:00,3,3,0,114,49,65,32,20,12,68,36
Tue 26 May 2020 12:00,9,8,1,150,42,108,51,33,18,101,54
Tue 26 May 2020 13:00,25,14,11,151,65,86,60,32,28,107,52
Tue 26 May 2020 14:00,11,7,4,169,80,89,56,36,20,118,35
Tue 26 May 2020 15:00,6,3,3,149,80,69,54,33,21,125,66
Tue 26 May 2020 16:00,17,10,7,187,94,93,86,50,36,136,85
Tue 26 May 2020 17:00,7,2,5,237,130,107,94,51,43,163,99
Tue 26 May 2020 18:00,16,7,9,236,106,130,89,51,38,157,79
Tue 26 May 2020 19:00,17,7,10,182,91,91,50,33,17,87,82
Tue 26 May 2020 20:00,14,5,9,128,77,51,45,22,23,55,33
Tue 26 May 2020 21:00,6,3,3,88,50,38,38,20,18,66,22
Tue 26 May 2020 22:00,10,8,2,50,27,23,24,12,12,13,15
Tue 26 May 2020 23:00,0,0,0,24,14,10,10,5,5,19,2
Wed 27 May 2020 00:00,1,0,1,5,3,2,4,3,1,6,5
Wed 27 May 2020 01:00,2,1,1,5,2,3,0,0,0,4,4
Wed 27 May 2020 02:00,0,0,0,3,1,2,2,1,1,3,1
Wed 27 May 2020 03:00,0,0,0,2,1,1,1,1,0,1,0
Wed 27 May 2020 04:00,1,0,1,10,4,6,0,0,0,4,6
Wed 27 May 2020 05:00,0,0,0,12,2,10,5,5,0,5,13
Wed 27 May 2020 06:00,5,2,3,79,12,67,66,60,6,17,70
Wed 27 May 2020 07:00,3,2,1,167,44,123,62,50,12,31,102
Wed 27 May 2020 08:00,3,3,0,179,59,120,70,63,7,35,109
Wed 27 May 2020 09:00,9,7,2,110,30,80,38,33,5,29,57
Wed 27 May 2020 10:00,7,5,2,103,38,65,32,27,5,44,44
Wed 27 May 2020 11:00,5,4,1,124,53,71,40,31,9,48,43
Wed 27 May 2020 12:00,14,7,7,157,56,101,55,32,23,74,55
Wed 27 May 2020 13:00,12,6,6,182,81,101,71,51,20,89,73
Wed 27 May 2020 14:00,8,5,3,159,59,100,75,51,24,96,61
Wed 27 May 2020 15:00,12,8,4,174,82,92,71,41,30,126,50
Wed 27 May 2020 16:00,13,11,2,224,114,110,76,30,46,132,68
Wed 27 May 2020 17:00,16,6,10,322,160,162,130,73,57,172,88
Wed 27 May 2020 18:00,13,7,6,254,147,107,108,57,51,152,71
Wed 27 May 2020 19:00,19,10,9,216,111,105,80,39,41,103,87
Wed 27 May 2020 20:00,8,4,4,188,99,89,59,34,25,68,57
Wed 27 May 2020 21:00,13,8,5,111,62,49,46,25,21,48,40
Wed 27 May 2020 22:00,9,7,2,46,33,13,30,16,14,43,19
Wed 27 May 2020 23:00,3,0,3,22,15,7,12,9,3,13,7
Thu 28 May 2020 00:00,0,0,0,11,4,7,5,2,3,12,2
Thu 28 May 2020 01:00,1,0,1,3,3,0,1,1,0,1,4
Thu 28 May 2020 02:00,0,0,0,1,1,0,1,0,1,1,0
Thu 28 May 2020 03:00,0,0,0,3,3,0,2,1,1,1,0
Thu 28 May 2020 04:00,1,0,1,8,3,5,1,1,0,0,5
Thu 28 May 2020 05:00,1,1,0,14,7,7,7,6,1,6,7
Thu 28 May 2020 06:00,2,1,1,87,15,72,58,54,4,18,66
Thu 28 May 2020 07:00,8,4,4,167,48,119,69,54,15,32,96
Thu 28 May 2020 08:00,6,5,1,132,7,125,62,58,4,33,89
Thu 28 May 2020 09:00,9,7,2,90,0,90,36,31,5,30,46
Thu 28 May 2020 10:00,6,3,3,73,3,70,42,33,9,64,31
Thu 28 May 2020 11:00,13,8,5,138,41,97,38,26,12,86,43
Thu 28 May 2020 12:00,4,2,2,155,61,94,53,36,17,94,53
Thu 28 May 2020 13:00,7,7,0,212,70,142,83,61,22,140,59
Thu 28 May 2020 14:00,21,15,6,185,65,120,71,36,35,121,76
Thu 28 May 2020 15:00,26,19,7,166,77,89,91,54,37,115,70
Thu 28 May 2020 16:00,16,7,9,258,138,120,124,75,49,142,103
Thu 28 May 2020 17:00,19,14,5,320,183,137,124,62,62,201,105
Thu 28 May 2020 18:00,14,5,9,305,148,157,83,48,35,144,68
Thu 28 May 2020 19:00,18,4,14,240,120,120,107,54,53,113,126
Thu 28 May 2020 20:00,9,4,5,179,97,82,63,33,30,67,103
Thu 28 May 2020 21:00,9,6,3,151,90,61,44,23,21,41,49
Thu 28 May 2020 22:00,6,4,2,82,49,33,42,18,24,30,19
Thu 28 May 2020 23:00,2,0,2,38,29,9,14,7,7,14,6
Fri 29 May 2020 00:00,1,0,1,16,11,5,7,2,5,10,3
Fri 29 May 2020 01:00,0,0,0,10,6,4,0,0,0,2,0
Fri 29 May 2020 02:00,1,1,0,8,3,5,2,0,2,4,0
Fri 29 May 2020 03:00,0,0,0,7,5,2,2,1,1,4,0
Fri 29 May 2020 04:00,1,0,1,14,6,8,3,3,0,6,1
Fri 29 May 2020 05:00,0,0,0,15,6,9,9,9,0,8,9
Fri 29 May 2020 06:00,3,3,0,92,15,77,49,46,3,16,65
Fri 29 May 2020 07:00,5,4,1,155,52,103,62,50,12,25,60
Fri 29 May 2020 08:00,11,8,3,180,65,115,58,52,6,38,98
Fri 29 May 2020 09:00,10,6,4,104,36,68,49,39,10,37,62
Fri 29 May 2020 10:00,10,7,3,98,25,73,33,24,9,58,38
Fri 29 May 2020 11:00,13,12,1,129,51,78,44,36,8,73,43
Fri 29 May 2020 12:00,17,13,4,176,67,109,56,35,21,90,53
Fri 29 May 2020 13:00,10,8,2,196,71,125,67,39,28,98,78
Fri 29 May 2020 14:00,12,9,3,184,75,109,85,54,31,137,51
Fri 29 May 2020 15:00,25,12,13,204,100,104,103,65,38,125,66
Fri 29 May 2020 16:00,25,12,13,245,102,143,88,41,47,154,89
Fri 29 May 2020 17:00,25,12,13,271,130,141,94,65,29,173,125
Fri 29 May 2020 18:00,21,12,9,287,139,148,95,48,47,141,97
Fri 29 May 2020 19:00,15,10,5,249,131,118,70,45,25,102,101
Fri 29 May 2020 20:00,13,6,7,183,100,83,75,43,32,69,93
Fri 29 May 2020 21:00,11,8,3,139,82,57,49,21,28,64,63
Fri 29 May 2020 22:00,5,1,4,87,52,35,26,12,14,38,23
Fri 29 May 2020 23:00,6,1,5,47,30,17,25,10,15,29,14
Sat 30 May 2020 00:00,4,3,1,23,8,15,9,3,6,22,9
Sat 30 May 2020 01:00,0,0,0,19,7,12,8,2,6,3,4
Sat 30 May 2020 02:00,1,0,1,8,5,3,3,3,0,6,4
Sat 30 May 2020 03:00,0,0,0,3,3,0,0,0,0,3,4
Sat 30 May 2020 04:00,0,0,0,7,3,4,3,3,0,0,2
Sat 30 May 2020 05:00,2,2,0,16,6,10,2,2,0,7,6
Sat 30 May 2020 06:00,0,0,0,34,9,25,15,14,1,14,13
Sat 30 May 2020 07:00,1,1,0,55,20,35,29,26,3,16,27
Sat 30 May 2020 08:00,5,3,2,67,19,48,29,29,0,28,29
Sat 30 May 2020 09:00,7,4,3,131,49,82,24,18,6,42,42
Sat 30 May 2020 10:00,12,6,6,138,50,88,46,29,17,73,38
Sat 30 May 2020 11:00,24,17,7,212,83,129,74,51,23,108,60
Sat 30 May 2020 12:00,11,6,5,187,68,119,87,56,31,153,101
Sat 30 May 2020 13:00,17,11,6,266,106,160,87,49,38,138,82
Sat 30 May 2020 14:00,16,9,7,262,111,151,113,72,41,138,93
Sat 30 May 2020 15:00,17,8,9,247,86,161,97,68,29,151,99
Sat 30 May 2020 16:00,11,8,3,251,121,130,70,42,28,147,106
Sat 30 May 2020 17:00,7,3,4,237,112,125,88,50,38,108,117
Sat 30 May 2020 18:00,14,7,7,247,123,124,87,49,38,94,138
Sat 30 May 2020 19:00,17,6,11,224,121,103,86,46,40,81,100
Sat 30 May 2020 20:00,12,8,4,171,88,83,53,36,17,74,104
Sat 30 May 2020 21:00,12,5,7,130,74,56,26,16,10,56,78
Sat 30 May 2020 22:00,11,5,6,98,60,38,52,28,24,47,41
Sat 30 May 2020 23:00,3,3,0,67,41,26,24,14,10,32,22
Sun 31 May 2020 00:00,3,0,3,32,23,9,12,7,5,12,8
Sun 31 May 2020 01:00,0,0,0,16,9,7,7,1,6,12,10
Sun 31 May 2020 02:00,0,0,0,12,6,6,2,0,2,5,4
Sun 31 May 2020 03:00,0,0,0,5,5,0,1,1,0,1,7
Sun 31 May 2020 04:00,0,0,0,10,5,5,0,0,0,3,2
Sun 31 May 2020 05:00,0,0,0,11,4,7,2,1,1,4,1
Sun 31 May 2020 06:00,1,1,0,22,5,17,12,10,2,11,12
Sun 31 May 2020 07:00,3,3,0,42,15,27,13,11,2,24,22
Sun 31 May 2020 08:00,1,1,0,54,25,29,15,14,1,28,27
Sun 31 May 2020 09:00,5,4,1,94,40,54,33,21,12,36,23
Sun 31 May 2020 10:00,15,9,6,152,45,107,49,37,12,79,54
Sun 31 May 2020 11:00,13,6,7,195,76,119,48,32,16,95,52
Sun 31 May 2020 12:00,16,14,2,230,103,127,118,71,47,99,87
Sun 31 May 2020 13:00,28,17,11,260,94,166,112,73,39,150,80
Sun 31 May 2020 14:00,18,9,9,262,94,168,119,71,48,157,128
Sun 31 May 2020 15:00,11,8,3,318,122,196,99,50,49,152,109
Sun 31 May 2020 16:00,20,12,8,219,102,117,103,56,47,126,108
Sun 31 May 2020 17:00,16,4,12,249,134,115,70,46,24,92,142
Sun 31 May 2020 18:00,12,6,6,209,107,102,67,44,23,84,116
Sun 31 May 2020 19:00,9,7,2,177,94,83,74,42,32,94,136
Sun 31 May 2020 20:00,13,4,9,141,83,58,67,41,26,59,87
Sun 31 May 2020 21:00,8,6,2,118,63,55,50,24,26,58,71
Sun 31 May 2020 22:00,8,4,4,82,43,39,45,25,20,41,36
Sun 31 May 2020 23:00,4,2,2,34,17,17,20,5,15,17,14
Mon 1 Jun 2020 00:00,0,0,0,19,13,6,4,2,2,2,9
Mon 1 Jun 2020 01:00,1,0,1,11,5,6,2,0,2,8,3
Mon 1 Jun 2020 02:00,0,0,0,11,8,3,3,1,2,7,1
Mon 1 Jun 2020 03:00,0,0,0,4,3,1,0,0,0,1,2
Mon 1 Jun 2020 04:00,0,0,0,11,3,8,1,0,1,8,4
Mon 1 Jun 2020 05:00,0,0,0,13,3,10,0,0,0,5,2
Mon 1 Jun 2020 06:00,0,0,0,26,8,18,14,14,0,10,16
Mon 1 Jun 2020 07:00,3,2,1,50,13,37,13,11,2,10,20
Mon 1 Jun 2020 08:00,3,2,1,88,25,63,21,19,2,21,42
Mon 1 Jun 2020 09:00,8,8,0,112,38,74,22,14,8,40,23
Mon 1 Jun 2020 10:00,9,8,1,133,46,87,35,23,12,108,42
Mon 1 Jun 2020 11:00,14,12,2,175,56,119,75,45,30,94,70
Mon 1 Jun 2020 12:00,20,16,4,219,77,142,98,60,38,141,77
Mon 1 Jun 2020 13:00,16,6,10,259,110,149,114,71,43,170,99
Mon 1 Jun 2020 14:00,24,15,9,278,101,177,121,75,46,142,134
Mon 1 Jun 2020 15:00,16,13,3,249,101,148,105,60,45,119,104
Mon 1 Jun 2020 16:00,21,14,7,266,122,144,80,40,40,127,95
Mon 1 Jun 2020 17:00,22,5,17,287,137,150,113,61,52,157,154
Mon 1 Jun 2020 18:00,4,3,1,257,164,93,92,55,37,109,106
Mon 1 Jun 2020 19:00,5,2,3,227,130,97,64,31,33,91,149
Mon 1 Jun 2020 20:00,7,2,5,169,94,75,66,37,29,65,119
Mon 1 Jun 2020 21:00,7,1,6,115,60,55,57,23,34,48,52
Mon 1 Jun 2020 22:00,5,2,3,55,32,23,30,11,19,36,34
Mon 1 Jun 2020 23:00,2,1,1,23,19,4,15,2,13,20,17
Tue 2 Jun 2020 00:00,2,1,1,9,4,5,7,5,2,6,7
Tue 2 Jun 2020 01:00,0,0,0,7,6,1,2,0,2,2,3
Tue 2 Jun 2020 02:00,0,0,0,2,0,2,1,0,1,7,1
Tue 2 Jun 2020 03:00,0,0,0,5,3,2,3,1,2,2,1
Tue 2 Jun 2020 04:00,1,0,1,13,4,9,1,0,1,5,5
Tue 2 Jun 2020 05:00,1,0,1,18,2,16,7,5,2,6,12
Tue 2 Jun 2020 06:00,2,2,0,78,10,68,54,51,3,9,67
Tue 2 Jun 2020 07:00,2,2,0,170,55,115,74,58,16,32,104
Tue 2 Jun 2020 08:00,9,6,3,195,64,131,66,63,3,26,113
Tue 2 Jun 2020 09:00,8,6,2,145,38,107,37,28,9,45,64
Tue 2 Jun 2020 10:00,9,8,1,100,30,70,44,32,12,55,57
Tue 2 Jun 2020 11:00,10,6,4,141,43,98,47,23,24,98,55
Tue 2 Jun 2020 12:00,14,8,6,158,60,98,79,48,31,108,46
Tue 2 Jun 2020 13:00,11,10,1,197,76,121,75,48,27,147,74
Tue 2 Jun 2020 14:00,16,10,6,183,74,109,54,32,22,142,90
Tue 2 Jun 2020 15:00,18,11,7,145,49,96,76,32,44,139,78
Tue 2 Jun 2020 16:00,11,6,5,235,129,106,80,43,37,151,64
Tue 2 Jun 2020 17:00,20,9,11,262,138,124,119,65,54,160,126
Tue 2 Jun 2020 18:00,19,7,12,298,161,137,102,55,47,143,114
Tue 2 Jun 2020 19:00,12,5,7,195,105,90,52,29,23,73,99
Tue 2 Jun 2020 20:00,14,9,5,192,105,87,66,35,31,68,77
Tue 2 Jun 2020 21:00,14,6,8,117,72,45,49,16,33,46,111
Tue 2 Jun 2020 22:00,7,0,7,55,39,16,31,19,12,25,54
Tue 2 Jun 2020 23:00,2,1,1,20,13,7,7,4,3,20,9
Wed 3 Jun 2020 00:00,0,0,0,4,4,0,4,3,1,4,2
Wed 3 Jun 2020 01:00,1,0,1,6,5,1,0,0,0,2,2
Wed 3 Jun 2020 02:00,0,0,0,2,0,2,1,1,0,2,3
Wed 3 Jun 2020 03:00,0,0,0,3,3,0,0,0,0,0,1
Wed 3 Jun 2020 04:00,1,0,1,13,4,9,3,3,0,3,5
Wed 3 Jun 2020 05:00,0,0,0,12,3,9,4,3,1,4,9
Wed 3 Jun 2020 06:00,2,2,0,90,18,72,62,58,4,11,71
Wed 3 Jun 2020 07:00,5,3,2,168,51,117,63,50,13,30,99
Wed 3 Jun 2020 08:00,8,7,1,170,58,112,76,68,8,23,104
Wed 3 Jun 2020 09:00,4,1,3,50,5,45,32,29,3,18,61
Wed 3 Jun 2020 10:00,4,3,1,37,3,34,13,9,4,19,26
Wed 3 Jun 2020 11:00,4,4,0,37,4,33,21,13,8,26,32
Wed 3 Jun 2020 12:00,6,4,2,40,6,34,21,12,9,31,20
Wed 3 Jun 2020 13:00,6,4,2,77,16,61,55,35,20,45,31
Wed 3 Jun 2020 14:00,9,5,4,115,43,72,34,19,15,57,34
Wed 3 Jun 2020 15:00,8,5,3,94,48,46,41,20,21,98,37
Wed 3 Jun 2020 16:00,12,5,7,174,96,78,75,40,35,106,38
Wed 3 Jun 2020 17:00,13,6,7,252,140,112,67,29,38,150,58
Wed 3 Jun 2020 18:00,6,4,2,209,111,98,76,58,18,114,47
Wed 3 Jun 2020 19:00,7,6,1,163,84,79,72,44,28,71,28
Wed 3 Jun 2020 20:00,5,4,1,103,44,59,40,26,14,44,36
Wed 3 Jun 2020 21:00,4,1,3,89,52,37,33,20,13,49,29
Wed 3 Jun 2020 22:00,3,0,3,33,19,14,16,8,8,30,12
Wed 3 Jun 2020 23:00,4,4,0,14,8,6,6,5,1,21,7
Thu 4 Jun 2020 00:00,1,0,1,2,0,2,4,2,2,1,6
Thu 4 Jun 2020 01:00,0,0,0,5,2,3,1,1,0,1,1
Thu 4 Jun 2020 02:00,1,0,1,1,1,0,0,0,0,0,0
Thu 4 Jun 2020 03:00,0,0,0,5,1,4,0,0,0,0,1
Thu 4 Jun 2020 04:00,1,0,1,12,4,8,2,2,0,4,2
Thu 4 Jun 2020 05:00,1,1,0,13,1,12,3,3,0,5,10
Thu 4 Jun 2020 06:00,4,4,0,90,12,78,67,63,4,13,69
Thu 4 Jun 2020 07:00,4,3,1,163,50,113,63,51,12,26,96
Thu 4 Jun 2020 08:00,5,5,0,163,52,111,73,71,2,30,112
Thu 4 Jun 2020 09:00,8,7,1,105,12,93,38,31,7,18,53
Thu 4 Jun 2020 10:00,4,4,0,68,6,62,24,17,7,19,48
Thu 4 Jun 2020 11:00,11,7,4,63,5,58,29,18,11,32,56
Thu 4 Jun 2020 12:00,9,5,4,64,9,55,34,26,8,56,43
Thu 4 Jun 2020 13:00,6,3,3,85,18,67,41,22,19,64,39
Thu 4 Jun 2020 14:00,12,9,3,105,54,51,28,18,10,57,31
Thu 4 Jun 2020 15:00,7,6,1,117,58,59,49,28,21,57,41
Thu 4 Jun 2020 16:00,12,5,7,174,97,77,61,34,27,106,39
Thu 4 Jun 2020 17:00,15,6,9,279,143,136,67,29,38,133,31
Thu 4 Jun 2020 18:00,6,3,3,197,103,94,75,43,32,125,36
Thu 4 Jun 2020 19:00,12,8,4,185,97,88,55,37,18,98,62
Thu 4 Jun 2020 20:00,6,4,2,139,71,68,43,19,24,61,66
Thu 4 Jun 2020 21:00,13,8,5,82,48,34,35,18,17,48,25
Thu 4 Jun 2020 22:00,3,1,2,63,31,32,34,11,23,30,21
Thu 4 Jun 2020 23:00,6,3,3,27,17,10,8,4,4,14,14
Fri 5 Jun 2020 00:00,0,0,0,9,5,4,0,0,0,7,1
Fri 5 Jun 2020 01:00,0,0,0,3,2,1,2,1,1,0,1
Fri 5 Jun 2020 02:00,0,0,0,7,2,5,1,1,0,3,3
Fri 5 Jun 2020 03:00,0,0,0,3,1,2,1,1,0,3,2
Fri 5 Jun 2020 04:00,1,1,0,13,3,10,1,1,0,2,3
Fri 5 Jun 2020 05:00,0,0,0,15,2,13,2,2,0,3,6
Fri 5 Jun 2020 06:00,3,3,0,64,9,55,53,49,4,7,74
Fri 5 Jun 2020 07:00,4,2,2,134,36,98,67,53,14,29,77
Fri 5 Jun 2020 08:00,4,3,1,168,55,113,65,61,4,19,92
Fri 5 Jun 2020 09:00,6,3,3,110,31,79,43,38,5,29,44
Fri 5 Jun 2020 10:00,9,4,5,79,25,54,38,33,5,43,36
Fri 5 Jun 2020 11:00,6,5,1,84,32,52,22,13,9,28,38
Fri 5 Jun 2020 12:00,8,6,2,126,49,77,34,21,13,52,48
Fri 5 Jun 2020 13:00,9,7,2,118,56,62,40,27,13,75,54
Fri 5 Jun 2020 14:00,12,7,5,107,51,56,45,19,26,81,62
Fri 5 Jun 2020 15:00,6,2,4,123,65,58,54,31,23,72,48
Fri 5 Jun 2020 16:00,7,5,2,165,78,87,51,27,24,105,29
Fri 5 Jun 2020 17:00,15,5,10,211,116,95,75,42,33,119,59
Fri 5 Jun 2020 18:00,8,7,1,184,95,89,51,33,18,123,43
Fri 5 Jun 2020 19:00,17,8,9,151,76,75,64,37,27,58,55
Fri 5 Jun 2020 20:00,14,8,6,103,54,49,36,26,10,54,46
Fri 5 Jun 2020 21:00,8,4,4,101,46,55,37,25,12,48,46
Fri 5 Jun 2020 22:00,1,0,1,61,32,29,28,18,10,34,6
Fri 5 Jun 2020 23:00,2,2,0,27,15,12,15,5,10,17,12
Sat 6 Jun 2020 00:00,0,0,0,19,11,8,7,6,1,7,5
Sat 6 Jun 2020 01:00,1,0,1,15,10,5,3,1,2,3,4
Sat 6 Jun 2020 02:00,0,0,0,5,1,4,0,0,0,3,0
Sat 6 Jun 2020 03:00,1,1,0,6,4,2,1,1,0,1,0
Sat 6 Jun 2020 04:00,0,0,0,7,3,4,2,2,0,4,1
Sat 6 Jun 2020 05:00,0,0,0,8,4,4,4,3,1,6,4
Sat 6 Jun 2020 06:00,0,0,0,15,4,11,9,8,1,10,10
Sat 6 Jun 2020 07:00,0,0,0,46,13,33,29,22,7,4,28
Sat 6 Jun 2020 08:00,7,5,2,35,11,24,17,15,2,13,20
Sat 6 Jun 2020 09:00,5,2,3,59,20,39,14,14,0,16,25
Sat 6 Jun 2020 10:00,5,2,3,62,20,42,25,18,7,18,28
Sat 6 Jun 2020 11:00,2,0,2,90,41,49,23,14,9,28,34
Sat 6 Jun 2020 12:00,9,4,5,103,46,57,31,24,7,45,41
Sat 6 Jun 2020 13:00,7,5,2,108,46,62,33,22,11,56,29
Sat 6 Jun 2020 14:00,2,1,1,163,47,116,72,57,15,52,50
Sat 6 Jun 2020 15:00,9,7,2,146,58,88,71,52,19,64,59
Sat 6 Jun 2020 16:00,8,5,3,146,83,63,43,22,21,60,63
Sat 6 Jun 2020 17:00,4,3,1,129,81,48,32,13,19,82,36
Sat 6 Jun 2020 18:00,3,2,1,118,60,58,37,18,19,57,35
Sat 6 Jun 2020 19:00,9,7,2,103,52,51,32,22,10,44,33
Sat 6 Jun 2020 20:00,3,1,2,96,52,44,30,16,14,43,28
Sat 6 Jun 2020 21:00,5,2,3,64,35,29,17,11,6,29,20
Sat 6 Jun 2020 22:00,1,1,0,60,36,24,18,10,8,19,14
Sat 6 Jun 2020 23:00,0,0,0,19,14,5,12,8,4,12,10
Sun 7 Jun 2020 00:00,1,1,0,17,8,9,4,4,0,7,2
Sun 7 Jun 2020 01:00,3,1,2,11,6,5,2,0,2,4,3
Sun 7 Jun 2020 02:00,2,2,0,5,4,1,3,0,3,6,5
Sun 7 Jun 2020 03:00,0,0,0,5,1,4,0,0,0,3,4
Sun 7 Jun 2020 04:00,0,0,0,6,1,5,0,0,0,2,3
Sun 7 Jun 2020 05:00,0,0,0,11,4,7,3,2,1,0,1
Sun 7 Jun 2020 06:00,0,0,0,14,5,9,3,2,1,8,8
Sun 7 Jun 2020 07:00,0,0,0,31,10,21,11,9,2,7,13
Sun 7 Jun 2020 08:00,4,4,0,32,16,16,21,17,4,23,19
Sun 7 Jun 2020 09:00,6,5,1,61,24,37,14,11,3,36,13
Sun 7 Jun 2020 10:00,6,2,4,100,30,70,31,18,13,35,31
Sun 7 Jun 2020 11:00,4,2,2,120,46,74,34,25,9,47,50
Sun 7 Jun 2020 12:00,12,6,6,159,71,88,71,39,32,89,60
Sun 7 Jun 2020 13:00,9,8,1,167,55,112,81,47,34,90,79
Sun 7 Jun 2020 14:00,10,6,4,226,88,138,64,44,20,91,72
Sun 7 Jun 2020 15:00,13,7,6,178,95,83,87,62,25,93,94
Sun 7 Jun 2020 16:00,8,3,5,213,105,108,57,28,29,118,78
Sun 7 Jun 2020 17:00,8,5,3,176,78,98,79,38,41,88,80
Sun 7 Jun 2020 18:00,6,0,6,190,79,111,83,43,40,75,69
Sun 7 Jun 2020 19:00,10,4,6,158,85,73,59,41,18,90,91
Sun 7 Jun 2020 20:00,3,2,1,166,74,92,60,29,31,52,69
Sun 7 Jun 2020 21:00,7,2,5,101,66,35,50,27,23,47,41
Sun 7 Jun 2020 22:00,5,5,0,72,43,29,27,16,11,36,23
Sun 7 Jun 2020 23:00,4,3,1,24,18,6,12,3,9,23,4
Mon 8 Jun 2020 00:00,0,0,0,7,4,3,4,4,0,6,7
Mon 8 Jun 2020 01:00,1,1,0,3,3,0,3,3,0,2,0
Mon 8 Jun 2020 02:00,0,0,0,5,2,3,4,2,2,2,2
Mon 8 Jun 2020 03:00,0,0,0,6,5,1,1,1,0,1,0
Mon 8 Jun 2020 04:00,1,0,1,7,3,4,4,4,0,8,3
Mon 8 Jun 2020 05:00,0,0,0,17,5,12,5,5,0,5,13
Mon 8 Jun 2020 06:00,2,2,0,92,20,72,72,65,7,15,75
Mon 8 Jun 2020 07:00,14,12,2,171,49,122,84,75,9,32,114
Mon 8 Jun 2020 08:00,6,5,1,196,57,139,74,70,4,33,133
Mon 8 Jun 2020 09:00,4,2,2,103,28,75,52,44,8,28,56
Mon 8 Jun 2020 10:00,5,3,2,76,24,52,28,21,7,39,55
Mon 8 Jun 2020 11:00,7,4,3,96,37,59,51,35,16,46,57
Mon 8 Jun 2020 12:00,5,3,2,135,52,83,41,32,9,61,60
Mon 8 Jun 2020 13:00,10,6,4,158,54,104,57,41,16,68,59
Mon 8 Jun 2020 14:00,14,12,2,156,67,89,55,31,24,110,57
Mon 8 Jun 2020 15:00,13,7,6,194,98,96,61,34,27,97,70
Mon 8 Jun 2020 16:00,18,9,9,198,109,89,83,36,47,162,69
Mon 8 Jun 2020 17:00,10,6,4,300,158,142,104,56,48,189,49
Mon 8 Jun 2020 18:00,16,12,4,270,139,131,99,49,50,177,83
Mon 8 Jun 2020 19:00,9,6,3,224,106,118,88,60,28,81,94
Mon 8 Jun 2020 20:00,1,0,1,157,79,78,57,32,25,79,57
Mon 8 Jun 2020 21:00,7,4,3,130,71,59,47,22,25,56,62
Mon 8 Jun 2020 22:00,2,2,0,59,37,22,40,20,20,24,16
Mon 8 Jun 2020 23:00,1,0,1,24,14,10,13,5,8,23,11
Tue 9 Jun 2020 00:00,0,0,0,10,5,5,0,0,0,9,7
Tue 9 Jun 2020 01:00,0,0,0,10,5,5,2,2,0,6,3
Tue 9 Jun 2020 02:00,0,0,0,2,1,1,0,0,0,2,2
Tue 9 Jun 2020 03:00,0,0,0,5,3,2,2,2,0,2,0
Tue 9 Jun 2020 04:00,0,0,0,8,3,5,3,3,0,2,5
Tue 9 Jun 2020 05:00,0,0,0,15,2,13,5,5,0,6,9
Tue 9 Jun 2020 06:00,4,4,0,93,12,81,69,64,5,16,67
Tue 9 Jun 2020 07:00,8,5,3,188,56,132,92,77,15,27,106
Tue 9 Jun 2020 08:00,6,6,0,200,56,144,80,73,7,36,144
Tue 9 Jun 2020 09:00,7,7,0,128,35,93,44,39,5,22,75
Tue 9 Jun 2020 10:00,10,6,4,52,8,44,29,22,7,27,39
Tue 9 Jun 2020 11:00,6,2,4,91,39,52,29,14,15,42,33
Tue 9 Jun 2020 12:00,3,1,2,127,53,74,31,25,6,53,54
Tue 9 Jun 2020 13:00,10,7,3,165,71,94,64,40,24,62,62
Tue 9 Jun 2020 14:00,5,2,3,137,71,66,59,36,23,77,49
Tue 9 Jun 2020 15:00,11,5,6,135,64,71,39,19,20,88,38
Tue 9 Jun 2020 16:00,5,4,1,184,101,83,66,30,36,111,52
Tue 9 Jun 2020 17:00,11,5,6,252,141,111,68,35,33,144,77
Tue 9 Jun 2020 18:00,8,5,3,214,134,80,70,39,31,163,38
Tue 9 Jun 2020 19:00,5,2,3,136,70,66,53,27,26,83,49
Tue 9 Jun 2020 20:00,3,2,1,108,54,54,40,22,18,55,57
Tue 9 Jun 2020 21:00,4,3,1,95,43,52,42,20,22,39,28
Tue 9 Jun 2020 22:00,3,3,0,51,33,18,31,12,19,23,29
Tue 9 Jun 2020 23:00,1,0,1,21,13,8,1,1,0,11,11
Wed 10 Jun 2020 00:00,1,0,1,8,3,5,2,2,0,5,8
Wed 10 Jun 2020 01:00,0,0,0,4,3,1,0,0,0,2,3
Wed 10 Jun 2020 02:00,0,0,0,2,0,2,0,0,0,6,3
Wed 10 Jun 2020 03:00,0,0,0,5,3,2,1,1,0,0,0
Wed 10 Jun 2020 04:00,0,0,0,10,3,7,1,1,0,1,1
Wed 10 Jun 2020 05:00,0,0,0,14,4,10,10,9,1,3,14
Wed 10 Jun 2020 06:00,1,1,0,75,12,63,67,59,8,11,63
Wed 10 Jun 2020 07:00,11,9,2,184,57,127,69,59,10,29,116
Wed 10 Jun 2020 08:00,8,8,0,191,60,131,65,58,7,25,115
Wed 10 Jun 2020 09:00,5,4,1,85,25,60,49,39,10,14,50
Wed 10 Jun 2020 10:00,5,4,1,48,18,30,28,23,5,24,22
Wed 10 Jun 2020 11:00,3,2,1,73,26,47,19,15,4,25,32
Wed 10 Jun 2020 12:00,6,3,3,90,40,50,23,17,6,41,33
Wed 10 Jun 2020 13:00,4,3,1,101,42,59,35,23,12,63,54
Wed 10 Jun 2020 14:00,7,4,3,111,51,60,44,25,19,56,50
Wed 10 Jun 2020 15:00,14,6,8,134,67,67,48,32,16,84,35
Wed 10 Jun 2020 16:00,12,7,5,165,98,67,59,31,28,136,35
Wed 10 Jun 2020 17:00,14,7,7,268,138,130,54,24,30,155,62
Wed 10 Jun 2020 18:00,6,1,5,207,122,85,60,30,30,123,42
Wed 10 Jun 2020 19:00,2,1,1,117,59,58,47,28,19,72,41
Wed 10 Jun 2020 20:00,13,3,10,78,41,37,45,20,25,46,31
Wed 10 Jun 2020 21:00,6,4,2,58,35,23,16,6,10,40,20
Wed 10 Jun 2020 22:00,2,0,2,39,26,13,16,8,8,23,15
Wed 10 Jun 2020 23:00,1,1,0,23,11,12,12,6,6,8,3
Thu 11 Jun 2020 00:00,1,0,1,7,4,3,2,2,0,2,1
Thu 11 Jun 2020 01:00,0,0,0,4,1,3,0,0,0,0,2
Thu 11 Jun 2020 02:00,1,0,1,0,0,0,1,1,0,1,1
Thu 11 Jun 2020 03:00,0,0,0,3,1,2,2,2,0,1,0
Thu 11 Jun 2020 04:00,0,0,0,9,2,7,4,4,0,1,3
Thu 11 Jun 2020 05:00,0,0,0,11,3,8,7,6,1,6,7
Thu 11 Jun 2020 06:00,4,4,0,59,8,51,58,55,3,14,69
Thu 11 Jun 2020 07:00,7,4,3,155,44,111,78,60,18,21,93
Thu 11 Jun 2020 08:00,6,4,2,145,52,93,77,71,6,22,88
Thu 11 Jun 2020 09:00,5,4,1,90,26,64,30,24,6,16,47
Thu 11 Jun 2020 10:00,7,6,1,82,29,53,20,19,1,29,32
Thu 11 Jun 2020 11:00,6,1,5,69,27,42,31,24,7,31,20
Thu 11 Jun 2020 12:00,14,5,9,108,41,67,27,15,12,39,34
Thu 11 Jun 2020 13:00,4,3,1,122,50,72,43,25,18,59,29
Thu 11 Jun 2020 14:00,9,6,3,126,50,76,31,18,13,56,38
Thu 11 Jun 2020 15:00,7,5,2,81,40,41,30,14,16,38,23
Thu 11 Jun 2020 16:00,2,1,1,86,54,32,25,14,11,73,37
Thu 11 Jun 2020 17:00,6,3,3,185,89,96,46,20,26,123,40
Thu 11 Jun 2020 18:00,6,4,2,188,105,83,63,41,22,124,42
Thu 11 Jun 2020 19:00,7,4,3,114,57,57,53,34,19,65,41
Thu 11 Jun 2020 20:00,5,2,3,84,48,36,36,22,14,45,22
Thu 11 Jun 2020 21:00,6,3,3,75,47,28,18,7,11,33,18
Thu 11 Jun 2020 22:00,6,5,1,32,22,10,14,6,8,32,17
Thu 11 Jun 2020 23:00,3,1,2,25,12,13,9,6,3,18,7
Fri 12 Jun 2020 00:00,1,0,1,10,6,4,4,4,0,6,2
Fri 12 Jun 2020 01:00,0,0,0,3,2,1,1,1,0,0,4
Fri 12 Jun 2020 02:00,1,1,0,1,1,0,0,0,0,0,0
Fri 12 Jun 2020 03:00,0,0,0,6,2,4,1,1,0,0,1
Fri 12 Jun 2020 04:00,1,0,1,8,4,4,2,2,0,2,2
Fri 12 Jun 2020 05:00,0,0,0,15,5,10,7,7,0,3,9
Fri 12 Jun 2020 06:00,5,1,4,56,9,47,49,43,6,11,62
Fri 12 Jun 2020 07:00,9,6,3,127,40,87,51,42,9,20,67
Fri 12 Jun 2020 08:00,5,4,1,137,46,91,65,60,5,14,81
Fri 12 Jun 2020 09:00,4,3,1,81,21,60,35,27,8,21,45
Fri 12 Jun 2020 10:00,4,1,3,72,17,55,31,21,10,16,34
Fri 12 Jun 2020 11:00,1,0,1,102,32,70,41,30,11,30,36
Fri 12 Jun 2020 12:00,6,3,3,101,34,67,42,28,14,49,42
Fri 12 Jun 2020 13:00,9,4,5,130,56,74,44,27,17,57,45
Fri 12 Jun 2020 14:00,6,3,3,112,49,63,32,21,11,57,52
Fri 12 Jun 2020 15:00,11,10,1,135,62,73,57,29,28,65,41
Fri 12 Jun 2020 16:00,15,8,7,157,70,87,67,31,36,110,40
Fri 12 Jun 2020 17:00,8,3,5,204,101,103,63,35,28,126,48
Fri 12 Jun 2020 18:00,11,7,4,180,86,94,51,31,20,110,60
Fri 12 Jun 2020 19:00,10,5,5,142,83,59,48,26,22,58,55
Fri 12 Jun 2020 20:00,8,3,5,108,51,57,43,24,19,30,35
Fri 12 Jun 2020 21:00,3,1,2,63,33,30,23,12,11,36,20
Fri 12 Jun 2020 22:00,5,2,3,67,46,21,25,16,9,24,13
Fri 12 Jun 2020 23:00,1,0,1,36,22,14,9,7,2,20,16
Sat 13 Jun 2020 00:00,2,1,1,22,15,7,7,5,2,8,7
Sat 13 Jun 2020 01:00,0,0,0,15,7,8,2,0,2,5,5
Sat 13 Jun 2020 02:00,0,0,0,13,6,7,1,1,0,2,6
Sat 13 Jun 2020 03:00,0,0,0,8,5,3,1,1,0,5,0
Sat 13 Jun 2020 04:00,0,0,0,9,6,3,0,0,0,2,1
Sat 13 Jun 2020 05:00,0,0,0,8,2,6,3,2,1,5,5
Sat 13 Jun 2020 06:00,2,1,1,16,2,14,10,10,0,9,6
Sat 13 Jun 2020 07:00,1,1,0,40,17,23,19,18,1,5,30
Sat 13 Jun 2020 08:00,3,3,0,51,15,36,22,19,3,10,24
Sat 13 Jun 2020 09:00,1,0,1,58,21,37,24,17,7,16,28
Sat 13 Jun 2020 10:00,7,2,5,64,22,42,36,18,18,43,36
Sat 13 Jun 2020 11:00,4,1,3,111,36,75,28,25,3,49,38
Sat 13 Jun 2020 12:00,6,5,1,132,53,79,48,31,17,62,70
Sat 13 Jun 2020 13:00,8,5,3,175,67,108,52,29,23,88,70
Sat 13 Jun 2020 14:00,8,5,3,157,62,95,69,40,29,68,66
Sat 13 Jun 2020 15:00,8,6,2,148,54,94,56,39,17,109,94
Sat 13 Jun 2020 16:00,7,3,4,173,75,98,63,31,32,119,89
Sat 13 Jun 2020 17:00,7,6,1,177,86,91,81,51,30,79,69
Sat 13 Jun 2020 18:00,10,8,2,192,98,94,68,41,27,107,82
Sat 13 Jun 2020 19:00,8,6,2,170,82,88,74,51,23,64,68
Sat 13 Jun 2020 20:00,7,2,5,147,72,75,52,33,19,46,68
Sat 13 Jun 2020 21:00,9,6,3,119,68,51,51,28,23,61,47
Sat 13 Jun 2020 22:00,6,1,5,67,44,23,32,14,18,38,34
Sat 13 Jun 2020 23:00,1,0,1,49,26,23,34,17,17,27,19
Sun 14 Jun 2020 00:00,0,0,0,35,20,15,8,5,3,19,9
Sun 14 Jun 2020 01:00,1,1,0,24,15,9,4,0,4,8,2
Sun 14 Jun 2020 02:00,0,0,0,23,12,11,5,4,1,3,2
Sun 14 Jun 2020 03:00,2,0,2,9,5,4,1,0,1,5,3
Sun 14 Jun 2020 04:00,0,0,0,5,3,2,2,0,2,11,2
Sun 14 Jun 2020 05:00,0,0,0,7,2,5,4,2,2,1,3
Sun 14 Jun 2020 06:00,2,1,1,15,5,10,9,8,1,4,8
Sun 14 Jun 2020 07:00,6,4,2,47,15,32,10,10,0,14,23
Sun 14 Jun 2020 08:00,5,4,1,51,17,34,34,30,4,26,40
Sun 14 Jun 2020 09:00,7,5,2,53,23,30,33,19,14,19,35
Sun 14 Jun 2020 10:00,6,5,1,104,34,70,47,29,18,60,48
Sun 14 Jun 2020 11:00,9,7,2,134,52,82,47,33,14,61,63
Sun 14 Jun 2020 12:00,11,6,5,196,81,115,79,48,31,102,99
Sun 14 Jun 2020 13:00,21,13,8,234,73,161,85,57,28,151,98
Sun 14 Jun 2020 14:00,10,4,6,225,101,124,74,53,21,127,93
Sun 14 Jun 2020 15:00,9,6,3,137,86,51,67,34,33,71,97
Sun 14 Jun 2020 16:00,5,4,1,145,63,82,73,38,35,81,95
Sun 14 Jun 2020 17:00,13,9,4,115,57,58,75,42,33,91,73
Sun 14 Jun 2020 18:00,11,10,1,174,97,77,48,31,17,81,85
Sun 14 Jun 2020 19:00,5,0,5,141,75,66,64,47,17,64,59
Sun 14 Jun 2020 20:00,3,0,3,141,64,77,51,30,21,68,58
Sun 14 Jun 2020 21:00,6,4,2,94,53,41,51,29,22,43,70
Sun 14 Jun 2020 22:00,4,1,3,63,43,20,22,17,5,40,30
Sun 14 Jun 2020 23:00,6,2,4,22,18,4,20,9,11,19,13
Mon 15 Jun 2020 00:00,0,0,0,5,3,2,3,1,2,8,3
Mon 15 Jun 2020 01:00,0,0,0,5,2,3,1,1,0,4,1
Mon 15 Jun 2020 02:00,0,0,0,2,2,0,4,2,2,0,1
Mon 15 Jun 2020 03:00,0,0,0,4,2,2,3,3,0,2,0
Mon 15 Jun 2020 04:00,0,0,0,8,4,4,1,1,0,1,3
Mon 15 Jun 2020 05:00,0,0,0,17,9,8,5,5,0,4,12
Mon 15 Jun 2020 06:00,4,4,0,97,15,82,59,54,5,10,69
Mon 15 Jun 2020 07:00,11,9,2,180,61,119,87,75,12,36,111
Mon 15 Jun 2020 08:00,5,5,0,208,74,134,75,69,6,37,143
Mon 15 Jun 2020 09:00,9,8,1,121,27,94,62,49,13,33,84
Mon 15 Jun 2020 10:00,11,4,7,85,27,58,41,30,11,35,56
Mon 15 Jun 2020 11:00,10,3,7,110,32,78,56,33,23,35,44
Mon 15 Jun 2020 12:00,12,7,5,142,65,77,55,33,22,57,64
Mon 15 Jun 2020 13:00,13,12,1,146,59,87,52,22,30,111,59
Mon 15 Jun 2020 14:00,12,6,6,136,57,79,57,37,20,104,71
Mon 15 Jun 2020 15:00,12,4,8,157,74,83,89,51,38,135,82
Mon 15 Jun 2020 16:00,18,12,6,217,105,112,80,46,34,186,95
Mon 15 Jun 2020 17:00,8,4,4,310,157,153,107,59,48,231,97
Mon 15 Jun 2020 18:00,11,9,2,285,146,139,108,58,50,181,67
Mon 15 Jun 2020 19:00,12,8,4,250,123,127,90,45,45,103,99
Mon 15 Jun 2020 20:00,13,5,8,182,110,72,81,33,48,57,101
Mon 15 Jun 2020 21:00,16,4,12,141,87,54,65,37,28,60,67
Mon 15 Jun 2020 22:00,4,1,3,75,51,24,44,19,25,36,42
Mon 15 Jun 2020 23:00,2,0,2,34,23,11,8,5,3,23,25
Tue 16 Jun 2020 00:00,0,0,0,14,9,5,3,1,2,7,9
Tue 16 Jun 2020 01:00,0,0,0,1,1,0,2,0,2,3,3
Tue 16 Jun 2020 02:00,0,0,0,4,2,2,0,0,0,2,1
Tue 16 Jun 2020 03:00,1,1,0,7,5,2,1,1,0,3,0
Tue 16 Jun 2020 04:00,0,0,0,7,3,4,1,1,0,4,3
Tue 16 Jun 2020 05:00,1,1,0,21,2,19,5,5,0,7,11
Tue 16 Jun 2020 06:00,4,4,0,106,17,89,69,63,6,14,77
Tue 16 Jun 2020 07:00,8,7,1,202,50,152,86,73,13,32,111
Tue 16 Jun 2020 08:00,10,9,1,216,66,150,86,71,15,35,143
Tue 16 Jun 2020 09:00,6,4,2,121,33,88,41,37,4,22,83
Tue 16 Jun 2020 10:00,4,3,1,73,20,53,22,15,7,17,52
Tue 16 Jun 2020 11:00,7,5,2,92,33,59,24,17,7,39,39
Tue 16 Jun 2020 12:00,9,2,7,114,42,72,44,30,14,37,59
Tue 16 Jun 2020 13:00,19,14,5,143,69,74,49,29,20,57,66
Tue 16 Jun 2020 14:00,13,6,7,119,57,62,49,22,27,66,61
Tue 16 Jun 2020 15:00,14,8,6,136,73,63,54,26,28,108,50
Tue 16 Jun 2020 16:00,15,9,6,215,108,107,67,35,32,120,44
Tue 16 Jun 2020 17:00,5,5,0,297,162,135,98,55,43,172,69
Tue 16 Jun 2020 18:00,22,14,8,265,138,127,94,56,38,167,54
Tue 16 Jun 2020 19:00,10,6,4,202,107,95,67,42,25,113,75
Tue 16 Jun 2020 20:00,10,3,7,134,72,62,40,22,18,70,57
Tue 16 Jun 2020 21:00,4,2,2,96,57,39,49,28,21,51,52
Tue 16 Jun 2020 22:00,0,0,0,66,41,25,23,15,8,25,23
Tue 16 Jun 2020 23:00,1,1,0,26,13,13,12,4,8,16,6
Wed 17 Jun 2020 00:00,0,0,0,13,9,4,5,4,1,6,7
Wed 17 Jun 2020 01:00,0,0,0,7,4,3,4,0,4,8,2
Wed 17 Jun 2020 02:00,0,0,0,2,2,0,0,0,0,6,1
Wed 17 Jun 2020 03:00,0,0,0,4,2,2,1,1,0,2,0
Wed 17 Jun 2020 04:00,0,0,0,10,3,7,1,1,0,1,2
Wed 17 Jun 2020 05:00,0,0,0,14,3,11,1,1,0,1,5
Wed 17 Jun 2020 06:00,4,4,0,48,6,42,36,32,4,6,39
Wed 17 Jun 2020 07:00,8,7,1,87,23,64,55,45,10,12,74
Wed 17 Jun 2020 08:00,3,3,0,165,55,110,67,64,3,15,108
Wed 17 Jun 2020 09:00,6,5,1,102,21,81,32,29,3,23,70
Wed 17 Jun 2020 10:00,3,2,1,76,22,54,32,25,7,22,45
Wed 17 Jun 2020 11:00,12,8,4,95,36,59,30,24,6,45,50
Wed 17 Jun 2020 12:00,7,3,4,115,45,70,39,27,12,42,49
Wed 17 Jun 2020 13:00,11,8,3,112,38,74,39,25,14,65,40
Wed 17 Jun 2020 14:00,3,3,0,119,46,73,38,23,15,48,64
Wed 17 Jun 2020 15:00,9,5,4,112,49,63,42,20,22,76,53
Wed 17 Jun 2020 16:00,4,2,2,135,69,66,64,36,28,103,68
Wed 17 Jun 2020 17:00,16,10,6,217,122,95,59,30,29,145,61
Wed 17 Jun 2020 18:00,13,9,4,202,110,92,93,59,34,144,62
Wed 17 Jun 2020 19:00,15,10,5,191,91,100,59,33,26,85,51
Wed 17 Jun 2020 20:00,3,2,1,130,63,67,52,28,24,52,63
Wed 17 Jun 2020 21:00,12,9,3,83,48,35,32,16,16,46,39
Wed 17 Jun 2020 22:00,6,1,5,63,43,20,30,13,17,35,18
Wed 17 Jun 2020 23:00,2,1,1,28,16,12,14,6,8,16,18
Thu 18 Jun 2020 00:00,4,4,0,21,11,10,3,2,1,11,8
Thu 18 Jun 2020 01:00,1,0,1,6,3,3,0,0,0,1,1
Thu 18 Jun 2020 02:00,1,0,1,4,1,3,2,2,0,3,3
Thu 18 Jun 2020 03:00,0,0,0,5,3,2,0,0,0,0,0
Thu 18 Jun 2020 04:00,0,0,0,5,2,3,4,4,0,2,3
Thu 18 Jun 2020 05:00,0,0,0,16,4,12,5,4,1,3,11
Thu 18 Jun 2020 06:00,7,7,0,85,10,75,75,67,8,29,64
Thu 18 Jun 2020 07:00,13,9,4,190,58,132,75,64,11,27,120
Thu 18 Jun 2020 08:00,4,4,0,199,59,140,99,90,9,35,146
Thu 18 Jun 2020 09:00,8,7,1,127,33,94,45,35,10,26,80
Thu 18 Jun 2020 10:00,2,2,0,78,28,50,39,30,9,26,54
Thu 18 Jun 2020 11:00,3,2,1,93,24,69,44,30,14,39,50
Thu 18 Jun 2020 12:00,10,4,6,139,46,93,42,28,14,56,53
Thu 18 Jun 2020 13:00,7,1,6,146,66,80,58,29,29,69,64
Thu 18 Jun 2020 14:00,7,5,2,126,59,67,37,25,12,59,63
Thu 18 Jun 2020 15:00,13,7,6,120,58,62,38,20,18,78,45
Thu 18 Jun 2020 16:00,7,5,2,162,90,72,76,41,35,109,45
Thu 18 Jun 2020 17:00,3,2,1,217,127,90,73,45,28,152,45
Thu 18 Jun 2020 18:00,7,1,6,195,108,87,71,36,35,152,44
Thu 18 Jun 2020 19:00,5,4,1,151,75,76,50,31,19,64,47
Thu 18 Jun 2020 20:00,6,4,2,121,70,51,40,27,13,59,60
Thu 18 Jun 2020 21:00,4,1,3,60,36,24,28,18,10,46,15
Thu 18 Jun 2020 22:00,2,2,0,52,37,15,15,5,10,20,12
Thu 18 Jun 2020 23:00,0,0,0,17,9,8,3,2,1,7,6
Fri 19 Jun 2020 00:00,0,0,0,11,6,5,3,0,3,8,0
Fri 19 Jun 2020 01:00,1,0,1,0,0,0,0,0,0,0,1
Fri 19 Jun 2020 02:00,1,0,1,4,3,1,1,0,1,0,1
Fri 19 Jun 2020 03:00,0,0,0,3,1,2,1,1,0,0,1
Fri 19 Jun 2020 04:00,0,0,0,9,4,5,0,0,0,3,1
Fri 19 Jun 2020 05:00,0,0,0,16,3,13,7,6,1,4,10
Fri 19 Jun 2020 06:00,4,3,1,59,9,50,60,56,4,13,48
Fri 19 Jun 2020 07:00,8,8,0,138,36,102,53,44,9,19,67
Fri 19 Jun 2020 08:00,5,4,1,161,44,117,66,64,2,17,93
Fri 19 Jun 2020 09:00,5,1,4,102,30,72,33,25,8,24,48
Fri 19 Jun 2020 10:00,2,2,0,77,23,54,18,16,2,20,35
Fri 19 Jun 2020 11:00,6,3,3,88,31,57,22,12,10,29,33
Fri 19 Jun 2020 12:00,4,4,0,108,43,65,38,22,16,45,49
Fri 19 Jun 2020 13:00,6,3,3,139,60,79,42,23,19,67,58
Fri 19 Jun 2020 14:00,10,7,3,125,61,64,44,23,21,45,55
Fri 19 Jun 2020 15:00,3,1,2,105,46,59,48,25,23,79,30
Fri 19 Jun 2020 16:00,7,5,2,153,81,72,62,31,31,91,45
Fri 19 Jun 2020 17:00,9,5,4,223,123,100,92,56,36,97,48
Fri 19 Jun 2020 18:00,10,5,5,208,106,102,71,43,28,129,60
Fri 19 Jun 2020 19:00,16,11,5,211,107,104,67,41,26,68,64
Fri 19 Jun 2020 20:00,10,5,5,143,72,71,65,39,26,87,63
Fri 19 Jun 2020 21:00,3,2,1,104,62,42,28,15,13,57,49
Fri 19 Jun 2020 22:00,12,7,5,66,39,27,35,19,16,26,24
Fri 19 Jun 2020 23:00,4,0,4,46,28,18,31,15,16,41,23
Sat 20 Jun 2020 00:00,1,0,1,27,14,13,14,12,2,15,4
Sat 20 Jun 2020 01:00,3,3,0,22,11,11,2,1,1,13,5
Sat 20 Jun 2020 02:00,0,0,0,12,7,5,3,0,3,6,8
Sat 20 Jun 2020 03:00,1,1,0,10,7,3,5,2,3,13,1
Sat 20 Jun 2020 04:00,0,0,0,17,4,13,1,1,0,6,3
Sat 20 Jun 2020 05:00,0,0,0,10,3,7,3,2,1,7,2
Sat 20 Jun 2020 06:00,1,1,0,25,6,19,16,15,1,11,12
Sat 20 Jun 2020 07:00,1,1,0,59,21,38,33,28,5,15,41
Sat 20 Jun 2020 08:00,12,12,0,73,22,51,32,28,4,29,47
Sat 20 Jun 2020 09:00,6,5,1,121,37,84,37,28,9,31,55
Sat 20 Jun 2020 10:00,19,10,9,138,56,82,51,31,20,75,48
Sat 20 Jun 2020 11:00,7,6,1,194,54,140,90,45,45,93,86
Sat 20 Jun 2020 12:00,17,9,8,172,78,94,75,52,23,132,123
Sat 20 Jun 2020 13:00,14,8,6,194,71,123,83,47,36,112,115
Sat 20 Jun 2020 14:00,14,9,5,206,100,106,84,51,33,142,115
Sat 20 Jun 2020 15:00,9,7,2,189,94,95,83,50,33,124,144
Sat 20 Jun 2020 16:00,14,6,8,177,79,98,75,38,37,80,127
Sat 20 Jun 2020 17:00,10,2,8,180,97,83,74,46,28,82,99
Sat 20 Jun 2020 18:00,3,1,2,176,98,78,51,35,16,80,77
Sat 20 Jun 2020 19:00,5,1,4,133,69,64,32,24,8,56,36
Sat 20 Jun 2020 20:00,3,2,1,98,60,38,40,26,14,43,40
Sat 20 Jun 2020 21:00,4,3,1,78,52,26,23,14,9,34,22
Sat 20 Jun 2020 22:00,4,2,2,46,29,17,18,12,6,24,20
Sat 20 Jun 2020 23:00,0,0,0,30,16,14,4,4,0,18,9
Sun 21 Jun 2020 00:00,2,1,1,26,14,12,7,4,3,13,6
Sun 21 Jun 2020 01:00,0,0,0,11,5,6,4,4,0,7,4
Sun 21 Jun 2020 02:00,0,0,0,8,5,3,4,2,2,3,1
Sun 21 Jun 2020 03:00,0,0,0,9,4,5,0,0,0,5,1
Sun 21 Jun 2020 04:00,0,0,0,13,5,8,4,4,0,8,17
Sun 21 Jun 2020 05:00,0,0,0,11,2,9,2,1,1,7,6
Sun 21 Jun 2020 06:00,1,0,1,21,4,17,11,8,3,6,14
Sun 21 Jun 2020 07:00,3,3,0,32,8,24,12,12,0,11,19
Sun 21 Jun 2020 08:00,1,0,1,46,11,35,22,15,7,31,18
Sun 21 Jun 2020 09:00,6,3,3,66,26,40,25,13,12,21,38
Sun 21 Jun 2020 10:00,3,2,1,73,29,44,23,16,7,33,30
Sun 21 Jun 2020 11:00,12,8,4,99,40,59,40,29,11,46,53
Sun 21 Jun 2020 12:00,6,4,2,114,54,60,53,37,16,65,71
Sun 21 Jun 2020 13:00,6,4,2,131,53,78,74,44,30,85,60
Sun 21 Jun 2020 14:00,15,10,5,161,71,90,72,37,35,82,82
Sun 21 Jun 2020 15:00,9,7,2,148,60,88,67,34,33,86,68
Sun 21 Jun 2020 16:00,10,7,3,135,50,85,44,26,18,81,89
Sun 21 Jun 2020 17:00,8,4,4,158,64,94,61,41,20,88,87
Sun 21 Jun 2020 18:00,8,5,3,151,75,76,61,30,31,59,74
Sun 21 Jun 2020 19:00,13,11,2,124,69,55,57,37,20,73,46
Sun 21 Jun 2020 20:00,12,6,6,110,61,49,49,25,24,57,63
Sun 21 Jun 2020 21:00,16,12,4,111,65,46,44,23,21,46,70
Sun 21 Jun 2020 22:00,6,2,4,60,43,17,37,17,20,44,27
Sun 21 Jun 2020 23:00,1,1,0,32,20,12,7,6,1,16,7
Mon 22 Jun 2020 00:00,0,0,0,12,8,4,9,8,1,15,11
Mon 22 Jun 2020 01:00,2,0,2,5,3,2,4,0,4,5,3
Mon 22 Jun 2020 02:00,1,1,0,4,3,1,1,1,0,4,0
Mon 22 Jun 2020 03:00,1,0,1,8,5,3,1,1,0,1,1
Mon 22 Jun 2020 04:00,0,0,0,8,3,5,3,2,1,2,6
Mon 22 Jun 2020 05:00,1,1,0,16,6,10,8,8,0,2,10
Mon 22 Jun 2020 06:00,4,4,0,61,10,51,58,55,3,7,53
Mon 22 Jun 2020 07:00,4,3,1,129,38,91,72,61,11,19,74
Mon 22 Jun 2020 08:00,6,5,1,187,71,116,64,63,1,27,104
Mon 22 Jun 2020 09:00,0,0,0,102,30,72,47,37,10,28,66
Mon 22 Jun 2020 10:00,2,2,0,50,12,38,20,16,4,19,40
Mon 22 Jun 2020 11:00,2,1,1,88,33,55,30,23,7,25,48
Mon 22 Jun 2020 12:00,8,6,2,110,45,65,49,33,16,40,45
Mon 22 Jun 2020 13:00,6,5,1,129,63,66,48,36,12,70,58
Mon 22 Jun 2020 14:00,10,6,4,89,35,54,44,27,17,50,46
Mon 22 Jun 2020 15:00,10,6,4,133,61,72,35,17,18,74,44
Mon 22 Jun 2020 16:00,11,6,5,175,93,82,50,24,26,118,41
Mon 22 Jun 2020 17:00,10,6,4,214,124,90,58,39,19,143,54
Mon 22 Jun 2020 18:00,16,13,3,196,111,85,69,42,27,150,67
Mon 22 Jun 2020 19:00,9,2,7,134,59,75,61,39,22,65,29
Mon 22 Jun 2020 20:00,8,5,3,128,63,65,31,15,16,55,41
Mon 22 Jun 2020 21:00,4,1,3,82,45,37,38,17,21,39,27
Mon 22 Jun 2020 22:00,4,1,3,52,32,20,23,13,10,34,19
Mon 22 Jun 2020 23:00,2,1,1,30,20,10,9,6,3,9,5
Tue 23 Jun 2020 00:00,0,0,0,13,5,8,7,3,4,7,5
Tue 23 Jun 2020 01:00,0,0,0,2,1,1,0,0,0,4,2
Tue 23 Jun 2020 02:00,0,0,0,4,1,3,0,0,0,0,3
Tue 23 Jun 2020 03:00,2,0,2,7,4,3,1,1,0,0,0
Tue 23 Jun 2020 04:00,0,0,0,5,2,3,2,2,0,1,6
Tue 23 Jun 2020 05:00,1,1,0,24,8,16,11,8,3,9,11
Tue 23 Jun 2020 06:00,6,5,1,70,13,57,67,58,9,14,62
Tue 23 Jun 2020 07:00,7,6,1,186,56,130,83,65,18,24,107
Tue 23 Jun 2020 08:00,9,9,0,196,64,132,86,78,8,31,150
Tue 23 Jun 2020 09:00,6,6,0,129,40,89,52,45,7,20,72
Tue 23 Jun 2020 10:00,5,3,2,72,19,53,26,19,7,20,48
Tue 23 Jun 2020 11:00,3,0,3,78,33,45,22,17,5,23,27
Tue 23 Jun 2020 12:00,8,4,4,126,48,78,39,26,13,61,45
Tue 23 Jun 2020 13:00,5,4,1,129,61,68,51,29,22,62,49
Tue 23 Jun 2020 14:00,6,4,2,121,67,54,45,26,19,62,61
Tue 23 Jun 2020 15:00,9,7,2,120,52,68,63,35,28,92,44
Tue 23 Jun 2020 16:00,10,1,9,177,95,82,89,41,48,146,79
Tue 23 Jun 2020 17:00,17,9,8,255,144,111,90,45,45,154,64
Tue 23 Jun 2020 18:00,10,5,5,239,122,117,71,38,33,157,63
Tue 23 Jun 2020 19:00,6,3,3,160,75,85,49,33,16,96,66
Tue 23 Jun 2020 20:00,9,5,4,115,62,53,40,20,20,50,53
Tue 23 Jun 2020 21:00,6,5,1,115,57,58,36,19,17,51,37
Tue 23 Jun 2020 22:00,9,6,3,85,53,32,24,12,12,37,23
Tue 23 Jun 2020 23:00,7,2,5,24,14,10,16,5,11,11,7
Wed 24 Jun 2020 00:00,0,0,0,8,4,4,5,3,2,14,12
Wed 24 Jun 2020 01:00,0,0,0,10,6,4,1,0,1,2,5
Wed 24 Jun 2020 02:00,0,0,0,3,2,1,2,0,2,4,2
Wed 24 Jun 2020 03:00,1,0,1,10,6,4,2,1,1,0,0
Wed 24 Jun 2020 04:00,2,0,2,10,3,7,1,1,0,0,7
Wed 24 Jun 2020 05:00,2,2,0,15,2,13,8,8,0,5,8
Wed 24 Jun 2020 06:00,6,5,1,93,17,76,64,56,8,16,65
Wed 24 Jun 2020 07:00,10,9,1,206,62,144,87,69,18,35,121
Wed 24 Jun 2020 08:00,4,4,0,232,70,162,85,77,8,33,152
Wed 24 Jun 2020 09:00,3,3,0,133,39,94,63,55,8,29,98
Wed 24 Jun 2020 10:00,5,5,0,101,35,66,41,36,5,28,56
Wed 24 Jun 2020 11:00,4,2,2,109,38,71,46,35,11,40,64
Wed 24 Jun 2020 12:00,10,7,3,164,74,90,60,39,21,65,66
Wed 24 Jun 2020 13:00,11,9,2,139,57,82,67,32,35,67,63
Wed 24 Jun 2020 14:00,15,10,5,148,63,85,61,38,23,77,46
Wed 24 Jun 2020 15:00,6,3,3,146,66,80,63,41,22,97,50
Wed 24 Jun 2020 16:00,14,4,10,214,117,97,74,44,30,143,58
Wed 24 Jun 2020 17:00,12,4,8,339,172,167,121,59,62,271,100
Wed 24 Jun 2020 18:00,14,4,10,281,142,139,128,69,59,186,69
Wed 24 Jun 2020 19:00,15,4,11,292,136,156,97,64,33,100,94
Wed 24 Jun 2020 20:00,13,5,8,206,113,93,70,40,30,87,117
Wed 24 Jun 2020 21:00,9,4,5,160,106,54,61,30,31,55,68
Wed 24 Jun 2020 22:00,1,1,0,92,62,30,31,14,17,40,44
Wed 24 Jun 2020 23:00,0,0,0,29,16,13,13,4,9,29,15
Thu 25 Jun 2020 00:00,0,0,0,21,15,6,11,5,6,8,6
Thu 25 Jun 2020 01:00,1,0,1,9,6,3,7,5,2,18,7
Thu 25 Jun 2020 02:00,0,0,0,3,2,1,2,0,2,4,1
Thu 25 Jun 2020 03:00,1,0,1,6,3,3,1,1,0,1,0
Thu 25 Jun 2020 04:00,1,1,0,7,2,5,1,1,0,2,5
Thu 25 Jun 2020 05:00,0,0,0,19,5,14,9,8,1,8,9
Thu 25 Jun 2020 06:00,5,4,1,91,25,66,70,63,7,24,71
Thu 25 Jun 2020 07:00,10,6,4,195,59,136,90,80,10,35,120
Thu 25 Jun 2020 08:00,4,3,1,226,60,166,84,78,6,33,157
Thu 25 Jun 2020 09:00,8,5,3,150,43,107,56,46,10,38,93
Thu 25 Jun 2020 10:00,10,7,3,110,28,82,31,18,13,60,54
Thu 25 Jun 2020 11:00,11,7,4,129,39,90,56,45,11,58,59
Thu 25 Jun 2020 12:00,6,6,0,164,61,103,56,36,20,105,69
Thu 25 Jun 2020 13:00,14,10,4,201,79,122,81,46,35,116,65
Thu 25 Jun 2020 14:00,9,6,3,200,82,118,71,43,28,145,91
Thu 25 Jun 2020 15:00,17,10,7,188,82,106,85,45,40,158,82
Thu 25 Jun 2020 16:00,8,5,3,255,121,134,95,49,46,166,97
Thu 25 Jun 2020 17:00,20,11,9,359,184,175,126,84,42,224,115
Thu 25 Jun 2020 18:00,13,6,7,327,155,172,102,54,48,218,145
Thu 25 Jun 2020 19:00,22,10,12,291,169,122,71,39,32,120,86
Thu 25 Jun 2020 20:00,11,3,8,185,104,81,67,29,38,92,101
Thu 25 Jun 2020 21:00,11,4,7,142,86,56,51,29,22,63,81
Thu 25 Jun 2020 22:00,7,6,1,76,52,24,37,18,19,44,31
Thu 25 Jun 2020 23:00,2,1,1,55,28,27,27,16,11,24,4
Fri 26 Jun 2020 00:00,0,0,0,24,17,7,4,3,1,10,8
Fri 26 Jun 2020 01:00,2,1,1,15,9,6,1,1,0,5,3
Fri 26 Jun 2020 02:00,0,0,0,5,2,3,1,1,0,2,1
Fri 26 Jun 2020 03:00,0,0,0,5,2,3,1,1,0,3,1
Fri 26 Jun 2020 04:00,0,0,0,8,4,4,1,1,0,4,5
Fri 26 Jun 2020 05:00,2,1,1,20,5,15,6,6,0,4,13
Fri 26 Jun 2020 06:00,4,4,0,71,12,59,69,63,6,17,61
Fri 26 Jun 2020 07:00,5,4,1,172,49,123,78,65,13,24,101
Fri 26 Jun 2020 08:00,7,6,1,212,62,150,91,84,7,32,139
Fri 26 Jun 2020 09:00,5,4,1,115,25,90,49,41,8,29,73
Fri 26 Jun 2020 10:00,6,5,1,89,23,66,34,24,10,33,57
Fri 26 Jun 2020 11:00,7,6,1,124,43,81,39,32,7,55,55
Fri 26 Jun 2020 12:00,4,2,2,183,65,118,57,40,17,68,57
Fri 26 Jun 2020 13:00,15,9,6,192,89,103,79,43,36,77,59
Fri 26 Jun 2020 14:00,5,2,3,174,73,101,59,35,24,88,46
Fri 26 Jun 2020 15:00,11,10,1,148,83,65,53,29,24,96,70
Fri 26 Jun 2020 16:00,12,7,5,229,114,115,67,37,30,135,59
Fri 26 Jun 2020 17:00,9,4,5,291,148,143,94,60,34,171,84
Fri 26 Jun 2020 18:00,11,6,5,242,103,139,94,62,32,151,104
Fri 26 Jun 2020 19:00,14,8,6,207,105,102,77,44,33,104,75
Fri 26 Jun 2020 20:00,5,4,1,149,68,81,53,31,22,63,45
Fri 26 Jun 2020 21:00,3,1,2,106,75,31,42,17,25,60,27
Fri 26 Jun 2020 22:00,5,4,1,82,59,23,26,18,8,46,21
Fri 26 Jun 2020 23:00,5,4,1,38,19,19,28,14,14,32,12
Sat 27 Jun 2020 00:00,4,2,2,35,25,10,10,2,8,33,7
Sat 27 Jun 2020 01:00,0,0,0,21,13,8,5,5,0,11,7
Sat 27 Jun 2020 02:00,0,0,0,11,4,7,2,2,0,3,3
Sat 27 Jun 2020 03:00,0,0,0,15,9,6,1,1,0,3,1
Sat 27 Jun 2020 04:00,0,0,0,7,3,4,2,2,0,1,2
Sat 27 Jun 2020 05:00,1,1,0,11,4,7,4,2,2,6,5
Sat 27 Jun 2020 06:00,2,1,1,27,4,23,18,15,3,8,18
Sat 27 Jun 2020 07:00,1,1,0,53,10,43,34,32,2,17,33
Sat 27 Jun 2020 08:00,9,8,1,50,15,35,32,25,7,37,33
Sat 27 Jun 2020 09:00,5,5,0,58,16,42,38,30,8,23,26
Sat 27 Jun 2020 10:00,6,3,3,69,29,40,35,24,11,30,20
Sat 27 Jun 2020 11:00,3,2,1,76,26,50,34,24,10,28,30
Sat 27 Jun 2020 12:00,3,1,2,81,41,40,32,24,8,34,24
Sat 27 Jun 2020 13:00,5,3,2,62,32,30,74,49,25,38,33
Sat 27 Jun 2020 14:00,4,0,4,116,56,60,67,40,27,46,41
Sat 27 Jun 2020 15:00,6,3,3,99,42,57,65,34,31,61,39
Sat 27 Jun 2020 16:00,10,3,7,116,59,57,49,28,21,57,61
Sat 27 Jun 2020 17:00,4,3,1,126,57,69,61,42,19,62,38
Sat 27 Jun 2020 18:00,7,6,1,120,60,60,65,44,21,62,57
Sat 27 Jun 2020 19:00,11,6,5,137,66,71,55,34,21,71,49
Sat 27 Jun 2020 20:00,8,5,3,83,42,41,32,20,12,44,35
Sat 27 Jun 2020 21:00,3,2,1,71,33,38,32,19,13,28,27
Sat 27 Jun 2020 22:00,0,0,0,70,41,29,23,9,14,22,20
Sat 27 Jun 2020 23:00,3,2,1,24,16,8,7,4,3,12,9
Sun 28 Jun 2020 00:00,1,0,1,21,7,14,3,2,1,7,9
Sun 28 Jun 2020 01:00,0,0,0,16,10,6,2,1,1,8,2
Sun 28 Jun 2020 02:00,1,0,1,8,4,4,6,2,4,2,1
Sun 28 Jun 2020 03:00,0,0,0,7,2,5,2,1,1,5,3
Sun 28 Jun 2020 04:00,0,0,0,16,9,7,0,0,0,3,5
Sun 28 Jun 2020 05:00,0,0,0,6,2,4,3,2,1,1,3
Sun 28 Jun 2020 06:00,1,0,1,21,7,14,7,5,2,5,12
Sun 28 Jun 2020 07:00,2,1,1,28,7,21,16,13,3,11,12
Sun 28 Jun 2020 08:00,2,2,0,29,7,22,21,16,5,16,17
Sun 28 Jun 2020 09:00,1,0,1,39,16,23,11,9,2,9,31
Sun 28 Jun 2020 10:00,1,1,0,65,22,43,27,18,9,27,22
Sun 28 Jun 2020 11:00,2,2,0,50,23,27,32,23,9,25,30
Sun 28 Jun 2020 12:00,7,2,5,61,25,36,34,23,11,49,38
Sun 28 Jun 2020 13:00,9,8,1,68,30,38,26,18,8,35,45
Sun 28 Jun 2020 14:00,3,2,1,90,39,51,47,32,15,38,28
Sun 28 Jun 2020 15:00,8,4,4,96,51,45,48,25,23,41,40
Sun 28 Jun 2020 16:00,8,2,6,86,39,47,46,23,23,54,40
Sun 28 Jun 2020 17:00,5,1,4,135,54,81,30,18,12,67,42
Sun 28 Jun 2020 18:00,8,5,3,94,45,49,48,29,19,60,49
Sun 28 Jun 2020 19:00,8,3,5,88,49,39,28,15,13,42,41
Sun 28 Jun 2020 20:00,5,2,3,70,44,26,38,27,11,30,38
Sun 28 Jun 2020 21:00,4,1,3,56,33,23,26,17,9,23,15
Sun 28 Jun 2020 22:00,5,3,2,40,30,10,10,5,5,16,5
Sun 28 Jun 2020 23:00,1,1,0,11,5,6,4,3,1,10,1
Mon 29 Jun 2020 00:00,2,0,2,4,0,4,3,3,0,2,3
Mon 29 Jun 2020 01:00,2,2,0,4,2,2,2,1,1,2,1
Mon 29 Jun 2020 02:00,0,0,0,1,1,0,0,0,0,0,0
Mon 29 Jun 2020 03:00,2,0,2,5,3,2,2,1,1,3,0
Mon 29 Jun 2020 04:00,0,0,0,10,3,7,0,0,0,3,4
Mon 29 Jun 2020 05:00,2,2,0,20,7,13,9,7,2,2,13
Mon 29 Jun 2020 06:00,7,5,2,60,9,51,71,61,10,8,54
Mon 29 Jun 2020 07:00,9,6,3,146,40,106,77,67,10,14,107
Mon 29 Jun 2020 08:00,5,5,0,179,49,130,81,73,8,24,139
Mon 29 Jun 2020 09:00,1,1,0,107,32,75,43,39,4,16,84
Mon 29 Jun 2020 10:00,6,4,2,67,21,46,25,20,5,15,35
Mon 29 Jun 2020 11:00,5,1,4,76,21,55,25,18,7,17,29
Mon 29 Jun 2020 12:00,8,0,8,97,36,61,40,28,12,37,35
Mon 29 Jun 2020 13:00,12,6,6,104,51,53,32,19,13,43,41
Mon 29 Jun 2020 14:00,6,2,4,95,43,52,41,28,13,61,52
Mon 29 Jun 2020 15:00,14,2,12,103,57,46,37,22,15,69,38
Mon 29 Jun 2020 16:00,6,3,3,155,69,86,53,17,36,109,35
Mon 29 Jun 2020 17:00,10,4,6,232,135,97,79,48,31,161,56
Mon 29 Jun 2020 18:00,13,8,5,181,106,75,83,45,38,119,49
Mon 29 Jun 2020 19:00,12,6,6,156,83,73,55,30,25,71,41
Mon 29 Jun 2020 20:00,10,6,4,88,45,43,54,24,30,47,23
Mon 29 Jun 2020 21:00,6,4,2,50,34,16,32,15,17,44,10
Mon 29 Jun 2020 22:00,2,1,1,47,25,22,19,9,10,21,9
Mon 29 Jun 2020 23:00,0,0,0,29,20,9,17,9,8,17,8
Tue 30 Jun 2020 00:00,0,0,0,13,9,4,3,1,2,4,6
Tue 30 Jun 2020 01:00,0,0,0,6,6,0,2,1,1,8,0
Tue 30 Jun 2020 02:00,0,0,0,5,2,3,2,2,0,0,0
Tue 30 Jun 2020 03:00,2,1,1,7,5,2,1,1,0,0,1
Tue 30 Jun 2020 04:00,1,0,1,7,1,6,0,0,0,1,7
Tue 30 Jun 2020 05:00,2,2,0,24,7,17,8,7,1,4,15
Tue 30 Jun 2020 06:00,5,5,0,93,16,77,78,67,11,17,63
Tue 30 Jun 2020 07:00,6,5,1,189,63,126,99,91,8,27,131
Tue 30 Jun 2020 08:00,5,4,1,258,69,189,94,88,6,31,152
Tue 30 Jun 2020 09:00,6,4,2,139,30,109,55,47,8,32,94
Tue 30 Jun 2020 10:00,1,1,0,107,39,68,25,18,7,25,53
Tue 30 Jun 2020 11:00,3,1,2,97,28,69,49,33,16,34,68
Tue 30 Jun 2020 12:00,6,4,2,141,53,88,36,22,14,43,57
Tue 30 Jun 2020 13:00,15,8,7,158,79,79,63,42,21,75,63
Tue 30 Jun 2020 14:00,8,2,6,131,54,77,50,30,20,68,52
Tue 30 Jun 2020 15:00,14,2,12,156,84,72,67,38,29,93,53
Tue 30 Jun 2020 16:00,10,9,1,175,86,89,79,37,42,141,78
Tue 30 Jun 2020 17:00,16,7,9,269,149,120,88,50,38,192,80
Tue 30 Jun 2020 18:00,20,13,7,279,155,124,111,60,51,206,51
Tue 30 Jun 2020 19:00,11,3,8,203,108,95,47,29,18,112,47
Tue 30 Jun 2020 20:00,4,2,2,141,75,66,72,41,31,58,59
Tue 30 Jun 2020 21:00,5,1,4,84,43,41,40,14,26,44,33
Tue 30 Jun 2020 22:00,3,3,0,67,42,25,20,12,8,35,24
Tue 30 Jun 2020 23:00,5,3,2,29,19,10,12,3,9,34,20
Wed 1 Jul 2020 00:00,1,1,0,18,13,5,4,2,2,10,9
Wed 1 Jul 2020 01:00,0,0,0,11,7,4,4,0,4,4,2
Wed 1 Jul 2020 02:00,0,0,0,2,2,0,0,0,0,1,2
Wed 1 Jul 2020 03:00,0,0,0,6,3,3,2,2,0,3,1
Wed 1 Jul 2020 04:00,1,0,1,12,5,7,0,0,0,2,3
Wed 1 Jul 2020 05:00,0,0,0,22,5,17,5,5,0,3,15
Wed 1 Jul 2020 06:00,3,3,0,83,14,69,75,69,6,19,72
Wed 1 Jul 2020 07:00,6,2,4,189,55,134,94,78,16,24,132
Wed 1 Jul 2020 08:00,8,7,1,235,64,171,91,82,9,36,159
Wed 1 Jul 2020 09:00,4,2,2,135,31,104,50,43,7,27,74
Wed 1 Jul 2020 10:00,1,1,0,66,21,45,17,13,4,20,36
Wed 1 Jul 2020 11:00,2,2,0,72,25,47,32,23,9,20,22
Wed 1 Jul 2020 12:00,5,4,1,97,37,60,34,22,12,34,29
Wed 1 Jul 2020 13:00,4,4,0,111,53,58,41,31,10,51,40
Wed 1 Jul 2020 14:00,7,4,3,93,40,53,28,21,7,45,30
Wed 1 Jul 2020 15:00,4,2,2,110,53,57,36,21,15,65,31
Wed 1 Jul 2020 16:00,6,2,4,151,79,72,67,37,30,118,38
Wed 1 Jul 2020 17:00,6,5,1,253,149,104,68,27,41,165,45
Wed 1 Jul 2020 18:00,4,3,1,189,112,77,80,37,43,136,36
Wed 1 Jul 2020 19:00,8,7,1,143,80,63,49,30,19,79,26
Wed 1 Jul 2020 20:00,3,2,1,94,48,46,34,15,19,50,21
Wed 1 Jul 2020 21:00,3,0,3,55,30,25,17,6,11,26,16
Wed 1 Jul 2020 22:00,0,0,0,35,26,9,14,7,7,28,11
Wed 1 Jul 2020 23:00,0,0,0,20,13,7,8,4,4,23,5
Thu 2 Jul 2020 00:00,1,0,1,13,8,5,0,0,0,8,6
Thu 2 Jul 2020 01:00,0,0,0,7,4,3,0,0,0,4,3
Thu 2 Jul 2020 02:00,1,0,1,4,3,1,0,0,0,0,1
Thu 2 Jul 2020 03:00,0,0,0,7,2,5,1,1,0,0,0
Thu 2 Jul 2020 04:00,2,1,1,10,2,8,1,1,0,3,4
Thu 2 Jul 2020 05:00,0,0,0,19,5,14,5,4,1,3,13
Thu 2 Jul 2020 06:00,4,4,0,100,20,80,80,71,9,16,68
Thu 2 Jul 2020 07:00,6,4,2,194,47,147,92,84,8,23,109
Thu 2 Jul 2020 08:00,6,6,0,231,62,169,98,91,7,28,154
Thu 2 Jul 2020 09:00,5,2,3,142,31,111,64,55,9,26,82
Thu 2 Jul 2020 10:00,6,2,4,97,38,59,40,33,7,21,45
Thu 2 Jul 2020 11:00,8,5,3,99,36,63,49,37,12,33,60
Thu 2 Jul 2020 12:00,11,8,3,138,48,90,61,35,26,60,68
Thu 2 Jul 2020 13:00,8,4,4,162,77,85,61,45,16,59,55
Thu 2 Jul 2020 14:00,7,2,5,145,65,80,43,27,16,85,55
Thu 2 Jul 2020 15:00,15,7,8,164,74,90,74,42,32,82,50
Thu 2 Jul 2020 16:00,10,5,5,232,129,103,85,49,36,126,65
Thu 2 Jul 2020 17:00,11,5,6,272,146,126,79,39,40,180,75
Thu 2 Jul 2020 18:00,16,5,11,278,154,124,110,61,49,178,90
Thu 2 Jul 2020 19:00,15,5,10,216,115,101,71,39,32,89,71
Thu 2 Jul 2020 20:00,11,5,6,156,80,76,68,35,33,83,60
Thu 2 Jul 2020 21:00,12,4,8,139,85,54,52,29,23,58,36
Thu 2 Jul 2020 22:00,4,1,3,76,46,30,30,9,21,58,20
Thu 2 Jul 2020 23:00,1,0,1,52,33,19,16,11,5,33,10
Fri 3 Jul 2020 00:00,2,0,2,23,17,6,8,2,6,17,6
Fri 3 Jul 2020 01:00,0,0,0,3,2,1,3,2,1,1,5
Fri 3 Jul 2020 02:00,2,0,2,6,3,3,0,0,0,2,2
Fri 3 Jul 2020 03:00,0,0,0,5,2,3,1,1,0,3,1
Fri 3 Jul 2020 04:00,2,1,1,6,3,3,3,3,0,4,3
Fri 3 Jul 2020 05:00,0,0,0,24,5,19,3,3,0,6,11
Fri 3 Jul 2020 06:00,4,4,0,78,10,68,66,58,8,16,53
Fri 3 Jul 2020 07:00,7,5,2,161,41,120,85,77,8,11,87
Fri 3 Jul 2020 08:00,11,9,2,174,39,135,74,66,8,24,95
Fri 3 Jul 2020 09:00,1,1,0,108,29,79,52,45,7,22,72
Fri 3 Jul 2020 10:00,4,2,2,77,25,52,29,22,7,15,52
Fri 3 Jul 2020 11:00,7,6,1,102,31,71,46,35,11,29,35
Fri 3 Jul 2020 12:00,10,7,3,122,54,68,48,35,13,43,38
Fri 3 Jul 2020 13:00,3,2,1,118,57,61,40,23,17,40,28
Fri 3 Jul 2020 14:00,4,2,2,125,50,75,35,18,17,35,28
Fri 3 Jul 2020 15:00,6,3,3,102,54,48,54,34,20,77,34
Fri 3 Jul 2020 16:00,6,3,3,169,89,80,57,32,25,88,28
Fri 3 Jul 2020 17:00,7,6,1,214,113,101,73,45,28,126,57
Fri 3 Jul 2020 18:00,4,1,3,192,97,95,55,35,20,108,65
Fri 3 Jul 2020 19:00,7,5,2,161,78,83,64,41,23,75,47
Fri 3 Jul 2020 20:00,5,4,1,140,74,66,58,37,21,53,46
Fri 3 Jul 2020 21:00,6,3,3,89,54,35,40,15,25,44,30
Fri 3 Jul 2020 22:00,4,3,1,78,47,31,31,12,19,39,27
Fri 3 Jul 2020 23:00,3,1,2,51,35,16,20,11,9,28,14
Sat 4 Jul 2020 00:00,0,0,0,26,15,11,13,7,6,13,9
Sat 4 Jul 2020 01:00,0,0,0,21,17,4,8,5,3,13,3
Sat 4 Jul 2020 02:00,2,1,1,8,5,3,1,0,1,8,3
Sat 4 Jul 2020 03:00,0,0,0,9,6,3,2,1,1,5,0
Sat 4 Jul 2020 04:00,2,1,1,11,2,9,1,1,0,1,4
Sat 4 Jul 2020 05:00,0,0,0,12,1,11,4,3,1,8,8
Sat 4 Jul 2020 06:00,2,1,1,36,9,27,18,16,2,10,22
Sat 4 Jul 2020 07:00,1,1,0,60,15,45,31,29,2,11,45
Sat 4 Jul 2020 08:00,3,2,1,64,23,41,31,26,5,14,34
Sat 4 Jul 2020 09:00,7,5,2,89,30,59,20,13,7,33,38
Sat 4 Jul 2020 10:00,3,1,2,99,26,73,37,28,9,47,46
Sat 4 Jul 2020 11:00,3,2,1,136,44,92,48,40,8,25,56
Sat 4 Jul 2020 12:00,3,3,0,125,44,81,43,21,22,62,74
Sat 4 Jul 2020 13:00,5,2,3,153,64,89,63,37,26,85,82
Sat 4 Jul 2020 14:00,12,11,1,140,57,83,55,35,20,60,62
Sat 4 Jul 2020 15:00,5,2,3,116,57,59,32,22,10,64,63
Sat 4 Jul 2020 16:00,4,3,1,125,48,77,44,33,11,78,52
Sat 4 Jul 2020 17:00,9,7,2,144,72,72,57,27,30,68,45
Sat 4 Jul 2020 18:00,5,4,1,141,70,71,43,28,15,77,63
Sat 4 Jul 2020 19:00,6,3,3,129,63,66,37,21,16,72,54
Sat 4 Jul 2020 20:00,9,6,3,119,68,51,41,17,24,49,58
Sat 4 Jul 2020 21:00,4,3,1,78,47,31,23,12,11,55,43
Sat 4 Jul 2020 22:00,1,0,1,80,50,30,35,26,9,33,31
Sat 4 Jul 2020 23:00,0,0,0,45,29,16,29,13,16,39,15
Sun 5 Jul 2020 00:00,0,0,0,24,15,9,12,4,8,20,10
Sun 5 Jul 2020 01:00,0,0,0,23,10,13,3,1,2,7,2
Sun 5 Jul 2020 02:00,1,0,1,10,7,3,7,5,2,9,2
Sun 5 Jul 2020 03:00,1,0,1,9,6,3,1,0,1,3,5
Sun 5 Jul 2020 04:00,2,0,2,9,2,7,0,0,0,3,1
Sun 5 Jul 2020 05:00,1,1,0,7,1,6,3,2,1,5,3
Sun 5 Jul 2020 06:00,1,0,1,15,2,13,10,10,0,8,6
Sun 5 Jul 2020 07:00,1,1,0,34,11,23,11,9,2,16,13
Sun 5 Jul 2020 08:00,0,0,0,48,18,30,18,12,6,16,28
Sun 5 Jul 2020 09:00,5,3,2,53,21,32,29,20,9,24,25
Sun 5 Jul 2020 10:00,4,2,2,72,27,45,31,26,5,32,32
Sun 5 Jul 2020 11:00,5,4,1,81,32,49,31,22,9,40,28
Sun 5 Jul 2020 12:00,4,2,2,105,41,64,45,26,19,46,43
Sun 5 Jul 2020 13:00,10,5,5,104,41,63,44,27,17,46,63
Sun 5 Jul 2020 14:00,6,6,0,86,39,47,42,26,16,51,63
Sun 5 Jul 2020 15:00,6,6,0,105,43,62,29,14,15,38,35
Sun 5 Jul 2020 16:00,5,2,3,89,33,56,37,22,15,46,37
Sun 5 Jul 2020 17:00,6,4,2,88,37,51,38,23,15,42,31
Sun 5 Jul 2020 18:00,4,2,2,100,48,52,47,31,16,45,45
Sun 5 Jul 2020 19:00,4,1,3,85,49,36,40,25,15,54,40
Sun 5 Jul 2020 20:00,2,1,1,98,61,37,44,25,19,37,37
Sun 5 Jul 2020 21:00,5,1,4,46,26,20,20,13,7,26,20
Sun 5 Jul 2020 22:00,5,3,2,47,32,15,19,9,10,29,22
Sun 5 Jul 2020 23:00,3,1,2,17,11,6,12,4,8,16,7
Mon 6 Jul 2020 00:00,0,0,0,4,2,2,3,1,2,7,3
Mon 6 Jul 2020 01:00,2,2,0,7,3,4,3,2,1,2,1
Mon 6 Jul 2020 02:00,0,0,0,6,5,1,1,0,1,1,1
Mon 6 Jul 2020 03:00,0,0,0,4,2,2,1,1,0,2,3
Mon 6 Jul 2020 04:00,0,0,0,8,4,4,1,1,0,2,3
Mon 6 Jul 2020 05:00,2,2,0,24,4,20,10,7,3,4,13
Mon 6 Jul 2020 06:00,4,4,0,89,14,75,78,70,8,14,73
Mon 6 Jul 2020 07:00,5,5,0,170,56,114,79,65,14,29,111
Mon 6 Jul 2020 08:00,12,8,4,214,40,174,94,88,6,25,143
Mon 6 Jul 2020 09:00,3,2,1,121,22,99,43,38,5,24,62
Mon 6 Jul 2020 10:00,4,3,1,86,32,54,28,22,6,24,31
Mon 6 Jul 2020 11:00,2,2,0,103,34,69,39,25,14,46,47
Mon 6 Jul 2020 12:00,8,3,5,122,47,75,50,33,17,46,46
Mon 6 Jul 2020 13:00,8,6,2,109,54,55,44,26,18,70,55
Mon 6 Jul 2020 14:00,15,8,7,104,46,58,46,27,19,70,49
Mon 6 Jul 2020 15:00,15,6,9,159,82,77,45,26,19,78,51
Mon 6 Jul 2020 16:00,10,5,5,189,100,89,53,27,26,112,62
Mon 6 Jul 2020 17:00,10,4,6,260,157,103,97,52,45,177,37
Mon 6 Jul 2020 18:00,17,14,3,221,114,107,78,48,30,160,53
Mon 6 Jul 2020 19:00,7,5,2,156,94,62,59,33,26,117,53
Mon 6 Jul 2020 20:00,6,6,0,130,71,59,55,31,24,78,63
Mon 6 Jul 2020 21:00,8,4,4,71,45,26,34,19,15,36,38
Mon 6 Jul 2020 22:00,1,1,0,64,39,25,27,17,10,35,25
Mon 6 Jul 2020 23:00,2,2,0,35,23,12,6,3,3,26,13
Tue 7 Jul 2020 00:00,1,0,1,10,6,4,3,2,1,9,6
Tue 7 Jul 2020 01:00,0,0,0,6,3,3,1,0,1,6,2
Tue 7 Jul 2020 02:00,0,0,0,2,1,1,2,1,1,4,4
Tue 7 Jul 2020 03:00,0,0,0,7,3,4,1,1,0,3,1
Tue 7 Jul 2020 04:00,0,0,0,5,2,3,2,2,0,4,5
Tue 7 Jul 2020 05:00,1,1,0,20,5,15,4,4,0,3,14
Tue 7 Jul 2020 06:00,4,4,0,71,13,58,74,67,7,10,63
Tue 7 Jul 2020 07:00,6,5,1,131,29,102,69,58,11,25,85
Tue 7 Jul 2020 08:00,9,7,2,201,46,155,91,82,9,23,135
Tue 7 Jul 2020 09:00,5,3,2,128,24,104,39,35,4,23,63
Tue 7 Jul 2020 10:00,7,3,4,73,15,58,24,18,6,13,42
Tue 7 Jul 2020 11:00,3,0,3,65,19,46,21,16,5,11,22
Tue 7 Jul 2020 12:00,2,2,0,86,33,53,32,22,10,28,24
Tue 7 Jul 2020 13:00,5,3,2,67,37,30,24,15,9,26,14
Tue 7 Jul 2020 14:00,5,4,1,69,30,39,26,15,11,48,25
Tue 7 Jul 2020 15:00,11,8,3,91,49,42,42,20,22,55,26
Tue 7 Jul 2020 16:00,6,5,1,130,81,49,39,21,18,85,39
Tue 7 Jul 2020 17:00,2,0,2,183,110,73,55,32,23,155,53
Tue 7 Jul 2020 18:00,9,7,2,145,96,49,46,21,25,118,20
Tue 7 Jul 2020 19:00,6,1,5,118,73,45,42,22,20,59,22
Tue 7 Jul 2020 20:00,3,3,0,79,44,35,29,15,14,31,25
Tue 7 Jul 2020 21:00,4,2,2,53,30,23,18,11,7,17,17
Tue 7 Jul 2020 22:00,4,4,0,28,17,11,12,5,7,19,13
Tue 7 Jul 2020 23:00,0,0,0,16,12,4,3,1,2,14,3
Wed 8 Jul 2020 00:00,1,1,0,7,5,2,1,0,1,4,5
Wed 8 Jul 2020 01:00,0,0,0,8,6,2,0,0,0,2,1
Wed 8 Jul 2020 02:00,0,0,0,3,2,1,1,0,1,0,0
Wed 8 Jul 2020 03:00,0,0,0,4,1,3,0,0,0,1,1
Wed 8 Jul 2020 04:00,0,0,0,6,2,4,2,2,0,3,3
Wed 8 Jul 2020 05:00,2,1,1,23,5,18,5,3,2,4,11
Wed 8 Jul 2020 06:00,3,3,0,82,16,66,73,65,8,15,63
Wed 8 Jul 2020 07:00,3,2,1,153,37,116,74,64,10,24,101
Wed 8 Jul 2020 08:00,9,6,3,202,60,142,96,80,16,23,140
Wed 8 Jul 2020 09:00,4,3,1,122,19,103,58,50,8,31,82
Wed 8 Jul 2020 10:00,6,4,2,68,27,41,30,23,7,14,42
Wed 8 Jul 2020 11:00,2,1,1,78,16,62,38,27,11,27,49
Wed 8 Jul 2020 12:00,8,8,0,122,55,67,52,40,12,40,45
Wed 8 Jul 2020 13:00,5,2,3,109,54,55,42,29,13,60,45
Wed 8 Jul 2020 14:00,5,3,2,89,47,42,28,14,14,39,45
Wed 8 Jul 2020 15:00,12,7,5,94,42,52,33,13,20,59,34
Wed 8 Jul 2020 16:00,4,1,3,124,77,47,43,27,16,93,45
Wed 8 Jul 2020 17:00,7,2,5,211,125,86,51,28,23,145,55
Wed 8 Jul 2020 18:00,5,2,3,166,106,60,53,35,18,90,27
Wed 8 Jul 2020 19:00,5,4,1,122,65,57,36,23,13,61,12
Wed 8 Jul 2020 20:00,3,1,2,59,29,30,29,10,19,39,16
Wed 8 Jul 2020 21:00,5,2,3,63,38,25,19,6,13,30,12
Wed 8 Jul 2020 22:00,2,1,1,19,15,4,13,6,7,28,16
Wed 8 Jul 2020 23:00,1,1,0,18,14,4,7,3,4,15,4
Thu 9 Jul 2020 00:00,1,0,1,12,11,1,3,1,2,9,3
Thu 9 Jul 2020 01:00,0,0,0,8,4,4,0,0,0,0,1
Thu 9 Jul 2020 02:00,0,0,0,4,2,2,0,0,0,2,1
Thu 9 Jul 2020 03:00,0,0,0,4,1,3,0,0,0,1,0
Thu 9 Jul 2020 04:00,1,1,0,6,0,6,2,2,0,2,5
Thu 9 Jul 2020 05:00,0,0,0,18,2,16,4,4,0,3,6
Thu 9 Jul 2020 06:00,1,1,0,71,11,60,78,73,5,14,60
Thu 9 Jul 2020 07:00,5,4,1,152,42,110,91,74,17,20,90
Thu 9 Jul 2020 08:00,9,8,1,199,46,153,87,78,9,23,118
Thu 9 Jul 2020 09:00,4,3,1,139,31,108,44,35,9,27,95
Thu 9 Jul 2020 10:00,2,2,0,75,26,49,27,25,2,19,43
Thu 9 Jul 2020 11:00,4,3,1,97,29,68,33,24,9,33,27
Thu 9 Jul 2020 12:00,4,3,1,155,60,95,32,23,9,43,51
Thu 9 Jul 2020 13:00,9,7,2,108,48,60,54,31,23,59,56
Thu 9 Jul 2020 14:00,6,3,3,129,58,71,54,30,24,59,44
Thu 9 Jul 2020 15:00,5,4,1,143,84,59,52,25,27,75,44
Thu 9 Jul 2020 16:00,11,6,5,180,99,81,69,44,25,122,67
Thu 9 Jul 2020 17:00,17,9,8,233,137,96,75,37,38,185,72
Thu 9 Jul 2020 18:00,13,8,5,239,132,107,90,59,31,181,62
Thu 9 Jul 2020 19:00,9,4,5,185,87,98,57,34,23,117,56
Thu 9 Jul 2020 20:00,5,2,3,133,71,62,48,18,30,61,55
Thu 9 Jul 2020 21:00,7,3,4,116,59,57,38,25,13,28,16
Thu 9 Jul 2020 22:00,5,3,2,77,45,32,29,12,17,35,22
Thu 9 Jul 2020 23:00,1,1,0,46,30,16,13,7,6,34,10
Fri 10 Jul 2020 00:00,0,0,0,22,20,2,9,5,4,18,3
Fri 10 Jul 2020 01:00,0,0,0,13,9,4,3,2,1,8,5
Fri 10 Jul 2020 02:00,0,0,0,5,3,2,0,0,0,4,1
Fri 10 Jul 2020 03:00,1,0,1,7,2,5,0,0,0,2,0
Fri 10 Jul 2020 04:00,1,1,0,11,4,7,4,4,0,2,4
Fri 10 Jul 2020 05:00,2,0,2,23,7,16,6,6,0,8,10
Fri 10 Jul 2020 06:00,4,4,0,89,19,70,80,72,8,15,64
Fri 10 Jul 2020 07:00,4,2,2,170,43,127,82,67,15,29,98
Fri 10 Jul 2020 08:00,7,6,1,237,54,183,91,80,11,37,157
Fri 10 Jul 2020 09:00,5,5,0,124,28,96,62,53,9,26,85
Fri 10 Jul 2020 10:00,7,6,1,104,25,79,38,29,9,25,77
Fri 10 Jul 2020 11:00,4,2,2,123,42,81,41,28,13,35,54
Fri 10 Jul 2020 12:00,13,9,4,145,62,83,54,38,16,71,62
Fri 10 Jul 2020 13:00,13,8,5,152,65,87,53,27,26,79,63
Fri 10 Jul 2020 14:00,6,2,4,143,65,78,47,26,21,84,67
Fri 10 Jul 2020 15:00,3,3,0,153,72,81,62,29,33,85,54
Fri 10 Jul 2020 16:00,13,7,6,193,93,100,84,53,31,108,59
Fri 10 Jul 2020 17:00,12,6,6,229,116,113,75,41,34,146,71
Fri 10 Jul 2020 18:00,9,8,1,214,105,109,81,39,42,137,59
Fri 10 Jul 2020 19:00,7,2,5,202,113,89,66,38,28,101,58
Fri 10 Jul 2020 20:00,5,5,0,157,77,80,41,24,17,72,83
Fri 10 Jul 2020 21:00,3,2,1,122,68,54,40,22,18,50,30
Fri 10 Jul 2020 22:00,2,1,1,67,43,24,32,14,18,55,28
Fri 10 Jul 2020 23:00,1,0,1,58,46,12,19,4,15,25,14
Sat 11 Jul 2020 00:00,1,1,0,46,26,20,11,4,7,31,5
Sat 11 Jul 2020 01:00,0,0,0,10,4,6,2,1,1,13,11
Sat 11 Jul 2020 02:00,1,1,0,13,10,3,1,0,1,15,5
Sat 11 Jul 2020 03:00,1,0,1,7,3,4,1,1,0,6,2
Sat 11 Jul 2020 04:00,1,1,0,15,7,8,1,1,0,4,3
Sat 11 Jul 2020 05:00,0,0,0,12,5,7,3,2,1,6,5
Sat 11 Jul 2020 06:00,1,0,1,37,9,28,22,20,2,11,33
Sat 11 Jul 2020 07:00,4,2,2,41,11,30,27,25,2,20,34
Sat 11 Jul 2020 08:00,5,2,3,62,26,36,36,29,7,21,32
Sat 11 Jul 2020 09:00,4,3,1,94,35,59,35,30,5,45,57
Sat 11 Jul 2020 10:00,5,4,1,122,33,89,49,33,16,74,77
Sat 11 Jul 2020 11:00,7,4,3,120,43,77,40,29,11,63,74
Sat 11 Jul 2020 12:00,18,4,14,168,60,108,67,36,31,78,74
Sat 11 Jul 2020 13:00,7,5,2,163,79,84,73,48,25,92,85
Sat 11 Jul 2020 14:00,18,15,3,164,72,92,55,30,25,76,83
Sat 11 Jul 2020 15:00,12,7,5,146,61,85,42,27,15,88,70
Sat 11 Jul 2020 16:00,13,6,7,123,50,73,45,29,16,77,83
Sat 11 Jul 2020 17:00,13,8,5,156,65,91,43,29,14,75,71
Sat 11 Jul 2020 18:00,4,3,1,131,72,59,69,37,32,78,77
Sat 11 Jul 2020 19:00,7,3,4,119,72,47,48,24,24,61,52
Sat 11 Jul 2020 20:00,9,4,5,112,66,46,40,29,11,51,44
Sat 11 Jul 2020 21:00,4,3,1,84,54,30,46,28,18,54,35
Sat 11 Jul 2020 22:00,4,3,1,77,41,36,36,18,18,48,26
Sat 11 Jul 2020 23:00,0,0,0,55,36,19,16,7,9,34,14
Sun 12 Jul 2020 00:00,0,0,0,36,18,18,16,8,8,28,11
Sun 12 Jul 2020 01:00,0,0,0,27,18,9,6,1,5,10,7
Sun 12 Jul 2020 02:00,0,0,0,16,6,10,5,3,2,5,6
Sun 12 Jul 2020 03:00,0,0,0,8,7,1,1,1,0,3,4
Sun 12 Jul 2020 04:00,1,0,1,8,2,6,0,0,0,3,2
Sun 12 Jul 2020 05:00,0,0,0,7,2,5,5,4,1,8,3
Sun 12 Jul 2020 06:00,1,0,1,26,8,18,6,5,1,7,11
Sun 12 Jul 2020 07:00,1,1,0,40,11,29,14,12,2,9,16
Sun 12 Jul 2020 08:00,2,2,0,48,12,36,27,19,8,18,39
Sun 12 Jul 2020 09:00,10,9,1,57,18,39,21,15,6,26,36
Sun 12 Jul 2020 10:00,5,4,1,101,32,69,41,25,16,42,33
Sun 12 Jul 2020 11:00,4,2,2,99,34,65,42,22,20,67,36
Sun 12 Jul 2020 12:00,12,10,2,130,60,70,59,36,23,92,53
Sun 12 Jul 2020 13:00,9,6,3,152,57,95,50,30,20,72,49
Sun 12 Jul 2020 14:00,10,6,4,134,60,74,71,44,27,79,56
Sun 12 Jul 2020 15:00,12,9,3,112,49,63,56,34,22,63,53
Sun 12 Jul 2020 16:00,10,3,7,117,57,60,67,38,29,54,47
Sun 12 Jul 2020 17:00,5,4,1,144,68,76,61,40,21,73,86
Sun 12 Jul 2020 18:00,11,3,8,124,60,64,60,33,27,80,67
Sun 12 Jul 2020 19:00,15,5,10,133,64,69,40,29,11,70,49
Sun 12 Jul 2020 20:00,3,2,1,113,56,57,38,20,18,50,49
Sun 12 Jul 2020 21:00,8,6,2,94,56,38,21,16,5,42,44
Sun 12 Jul 2020 22:00,2,1,1,64,44,20,28,9,19,39,24
Sun 12 Jul 2020 23:00,0,0,0,28,19,9,15,6,9,16,10
Mon 13 Jul 2020 00:00,0,0,0,8,5,3,4,2,2,9,3
Mon 13 Jul 2020 01:00,0,0,0,9,7,2,1,0,1,3,1
Mon 13 Jul 2020 02:00,0,0,0,5,4,1,0,0,0,2,3
Mon 13 Jul 2020 03:00,0,0,0,5,3,2,1,1,0,3,2
Mon 13 Jul 2020 04:00,0,0,0,6,3,3,1,1,0,3,3
Mon 13 Jul 2020 05:00,1,0,1,23,5,18,7,6,1,4,18
Mon 13 Jul 2020 06:00,5,5,0,93,16,77,81,71,10,9,81
Mon 13 Jul 2020 07:00,12,9,3,189,54,135,109,92,17,15,125
Mon 13 Jul 2020 08:00,4,3,1,215,62,153,97,86,11,30,155
Mon 13 Jul 2020 09:00,6,4,2,118,31,87,45,40,5,26,84
Mon 13 Jul 2020 10:00,3,3,0,84,24,60,36,31,5,23,49
Mon 13 Jul 2020 11:00,8,7,1,79,22,57,36,26,10,22,34
Mon 13 Jul 2020 12:00,3,3,0,104,31,73,35,22,13,43,46
Mon 13 Jul 2020 13:00,15,10,5,95,46,49,39,27,12,69,55
Mon 13 Jul 2020 14:00,12,7,5,125,59,66,37,20,17,66,32
Mon 13 Jul 2020 15:00,14,8,6,143,68,75,45,20,25,75,41
Mon 13 Jul 2020 16:00,13,8,5,204,114,90,78,48,30,135,55
Mon 13 Jul 2020 17:00,19,9,10,293,154,139,112,54,58,205,75
Mon 13 Jul 2020 18:00,12,8,4,233,146,87,95,52,43,162,56
Mon 13 Jul 2020 19:00,8,3,5,146,84,62,55,31,24,79,60
Mon 13 Jul 2020 20:00,6,3,3,88,44,44,46,24,22,63,47
Mon 13 Jul 2020 21:00,11,7,4,90,53,37,36,21,15,43,20
Mon 13 Jul 2020 22:00,10,4,6,52,32,20,26,11,15,28,22
Mon 13 Jul 2020 23:00,1,1,0,22,19,3,9,3,6,29,5
Tue 14 Jul 2020 00:00,1,0,1,15,9,6,0,0,0,3,8
Tue 14 Jul 2020 01:00,1,0,1,9,6,3,3,3,0,2,1
Tue 14 Jul 2020 02:00,0,0,0,3,1,2,1,1,0,2,0
Tue 14 Jul 2020 03:00,0,0,0,8,5,3,0,0,0,0,0
Tue 14 Jul 2020 04:00,0,0,0,9,3,6,2,2,0,3,6
Tue 14 Jul 2020 05:00,2,1,1,29,7,22,5,4,1,7,14
Tue 14 Jul 2020 06:00,5,5,0,95,16,79,83,73,10,7,72
Tue 14 Jul 2020 07:00,12,6,6,195,63,132,106,88,18,26,127
Tue 14 Jul 2020 08:00,10,6,4,248,70,178,105,93,12,33,180
Tue 14 Jul 2020 09:00,8,5,3,154,31,123,47,40,7,27,82
Tue 14 Jul 2020 10:00,3,0,3,88,30,58,45,35,10,23,60
Tue 14 Jul 2020 11:00,4,2,2,92,33,59,29,24,5,39,43
Tue 14 Jul 2020 12:00,8,5,3,105,30,75,45,27,18,57,53
Tue 14 Jul 2020 13:00,2,1,1,94,48,46,45,32,13,45,31
Tue 14 Jul 2020 14:00,10,6,4,81,40,41,35,24,11,51,33
Tue 14 Jul 2020 15:00,6,2,4,116,73,43,33,16,17,55,47
Tue 14 Jul 2020 16:00,7,4,3,131,73,58,57,34,23,107,41
Tue 14 Jul 2020 17:00,4,3,1,225,136,89,52,31,21,151,40
Tue 14 Jul 2020 18:00,8,5,3,208,117,91,63,40,23,156,31
Tue 14 Jul 2020 19:00,4,1,3,119,67,52,51,33,18,76,29
Tue 14 Jul 2020 20:00,4,1,3,82,46,36,42,23,19,48,40
Tue 14 Jul 2020 21:00,2,2,0,69,45,24,32,17,15,34,22
Tue 14 Jul 2020 22:00,6,2,4,44,29,15,17,7,10,40,15
Tue 14 Jul 2020 23:00,2,2,0,18,13,5,13,6,7,12,8
Wed 15 Jul 2020 00:00,0,0,0,12,8,4,5,1,4,7,3
Wed 15 Jul 2020 01:00,0,0,0,3,1,2,0,0,0,3,0
Wed 15 Jul 2020 02:00,0,0,0,6,4,2,0,0,0,1,2
Wed 15 Jul 2020 03:00,0,0,0,5,3,2,2,2,0,1,0
Wed 15 Jul 2020 04:00,0,0,0,8,2,6,3,3,0,1,3
Wed 15 Jul 2020 05:00,3,2,1,27,5,22,6,4,2,4,12
Wed 15 Jul 2020 06:00,5,5,0,85,17,68,86,79,7,12,76
Wed 15 Jul 2020 07:00,6,4,2,188,48,140,87,74,13,23,125
Wed 15 Jul 2020 08:00,9,7,2,227,60,167,111,101,10,32,176
Wed 15 Jul 2020 09:00,6,5,1,136,24,112,57,54,3,22,95
Wed 15 Jul 2020 10:00,6,5,1,95,26,69,32,23,9,24,48
Wed 15 Jul 2020 11:00,4,2,2,94,31,63,57,41,16,34,44
Wed 15 Jul 2020 12:00,8,4,4,102,37,65,54,31,23,60,42
Wed 15 Jul 2020 13:00,8,7,1,135,48,87,59,45,14,59,46
Wed 15 Jul 2020 14:00,13,12,1,124,58,66,49,27,22,76,46
Wed 15 Jul 2020 15:00,13,8,5,156,79,77,42,17,25,107,51
Wed 15 Jul 2020 16:00,8,6,2,176,99,77,57,31,26,122,55
Wed 15 Jul 2020 17:00,12,8,4,279,154,125,108,61,47,195,71
Wed 15 Jul 2020 18:00,9,8,1,285,138,147,98,60,38,180,73
Wed 15 Jul 2020 19:00,10,3,7,190,105,85,52,25,27,115,61
Wed 15 Jul 2020 20:00,10,2,8,141,74,67,46,19,27,77,48
Wed 15 Jul 2020 21:00,7,6,1,111,68,43,40,21,19,63,40
Wed 15 Jul 2020 22:00,2,1,1,66,44,22,40,22,18,49,36
Wed 15 Jul 2020 23:00,5,2,3,45,29,16,21,12,9,33,18
Thu 16 Jul 2020 00:00,2,0,2,19,15,4,6,2,4,13,9
Thu 16 Jul 2020 01:00,0,0,0,4,2,2,2,1,1,6,2
Thu 16 Jul 2020 02:00,0,0,0,8,5,3,2,1,1,2,5
Thu 16 Jul 2020 03:00,1,0,1,6,3,3,2,1,1,3,1
Thu 16 Jul 2020 04:00,6,6,0,7,1,6,3,3,0,6,6
Thu 16 Jul 2020 05:00,3,3,0,27,6,21,9,7,2,8,17
Thu 16 Jul 2020 06:00,6,5,1,106,27,79,79,68,11,14,79
Thu 16 Jul 2020 07:00,5,3,2,224,72,152,110,95,15,29,122
Thu 16 Jul 2020 08:00,11,8,3,270,62,208,92,83,9,37,165
Thu 16 Jul 2020 09:00,4,3,1,147,34,113,58,52,6,26,107
Thu 16 Jul 2020 10:00,3,2,1,82,18,64,31,23,8,32,60
Thu 16 Jul 2020 11:00,6,3,3,118,39,79,45,34,11,41,47
Thu 16 Jul 2020 12:00,10,5,5,143,52,91,60,47,13,48,49
Thu 16 Jul 2020 13:00,13,6,7,131,58,73,61,36,25,80,74
Thu 16 Jul 2020 14:00,12,5,7,147,61,86,74,46,28,85,56
Thu 16 Jul 2020 15:00,14,9,5,156,93,63,57,29,28,94,45
Thu 16 Jul 2020 16:00,18,13,5,196,103,93,91,55,36,136,66
Thu 16 Jul 2020 17:00,22,12,10,305,163,142,131,72,59,224,70
Thu 16 Jul 2020 18:00,15,5,10,279,138,141,128,70,58,198,65
Thu 16 Jul 2020 19:00,16,7,9,225,103,122,73,45,28,114,82
Thu 16 Jul 2020 20:00,19,11,8,157,99,58,56,26,30,83,77
Thu 16 Jul 2020 21:00,12,8,4,110,70,40,39,22,17,76,60
Thu 16 Jul 2020 22:00,9,4,5,85,56,29,45,19,26,47,37
Thu 16 Jul 2020 23:00,2,0,2,48,33,15,26,8,18,49,15
Fri 17 Jul 2020 00:00,1,0,1,25,16,9,6,5,1,32,7
Fri 17 Jul 2020 01:00,0,0,0,13,8,5,9,6,3,5,6
Fri 17 Jul 2020 02:00,0,0,0,9,5,4,0,0,0,1,0
Fri 17 Jul 2020 03:00,1,0,1,8,3,5,1,1,0,2,2
Fri 17 Jul 2020 04:00,0,0,0,12,2,10,6,5,1,6,4
Fri 17 Jul 2020 05:00,2,1,1,23,6,17,8,7,1,5,15
Fri 17 Jul 2020 06:00,4,3,1,97,13,84,80,67,13,16,62
Fri 17 Jul 2020 07:00,13,7,6,157,48,109,103,87,16,27,125
Fri 17 Jul 2020 08:00,6,6,0,216,68,148,92,82,10,34,141
Fri 17 Jul 2020 09:00,6,5,1,126,29,97,43,37,6,23,80
Fri 17 Jul 2020 10:00,11,9,2,94,27,67,44,33,11,31,51
Fri 17 Jul 2020 11:00,3,3,0,115,36,79,45,34,11,43,34
Fri 17 Jul 2020 12:00,5,2,3,149,54,95,56,37,19,56,70
Fri 17 Jul 2020 13:00,7,4,3,128,55,73,63,41,22,67,52
Fri 17 Jul 2020 14:00,6,5,1,135,61,74,48,25,23,63,52
Fri 17 Jul 2020 15:00,9,7,2,156,75,81,68,24,44,77,59
Fri 17 Jul 2020 16:00,22,19,3,163,84,79,66,43,23,110,63
Fri 17 Jul 2020 17:00,14,9,5,229,126,103,96,62,34,155,60
Fri 17 Jul 2020 18:00,13,6,7,234,127,107,68,39,29,121,69
Fri 17 Jul 2020 19:00,6,3,3,170,75,95,56,26,30,97,62
Fri 17 Jul 2020 20:00,1,1,0,138,64,74,59,32,27,58,54
Fri 17 Jul 2020 21:00,9,5,4,136,80,56,40,25,15,39,19
Fri 17 Jul 2020 22:00,5,3,2,59,42,17,35,17,18,38,22
Fri 17 Jul 2020 23:00,4,2,2,41,25,16,18,9,9,54,12
Sat 18 Jul 2020 00:00,1,0,1,41,27,14,15,5,10,13,4
Sat 18 Jul 2020 01:00,1,1,0,20,12,8,9,5,4,13,6
Sat 18 Jul 2020 02:00,0,0,0,13,9,4,3,1,2,11,0
Sat 18 Jul 2020 03:00,0,0,0,4,2,2,1,0,1,2,2
Sat 18 Jul 2020 04:00,1,1,0,10,4,6,2,2,0,3,4
Sat 18 Jul 2020 05:00,0,0,0,11,2,9,5,4,1,2,4
Sat 18 Jul 2020 06:00,4,3,1,35,10,25,21,20,1,6,16
Sat 18 Jul 2020 07:00,2,0,2,45,14,31,32,29,3,6,23
Sat 18 Jul 2020 08:00,2,1,1,60,15,45,23,21,2,19,39
Sat 18 Jul 2020 09:00,4,4,0,48,14,34,26,18,8,21,33
Sat 18 Jul 2020 10:00,6,4,2,102,31,71,29,24,5,28,36
Sat 18 Jul 2020 11:00,13,10,3,119,30,89,37,22,15,43,52
Sat 18 Jul 2020 12:00,6,4,2,161,64,97,52,28,24,63,49
Sat 18 Jul 2020 13:00,21,13,8,171,73,98,83,44,39,89,67
Sat 18 Jul 2020 14:00,15,9,6,160,67,93,70,42,28,94,83
Sat 18 Jul 2020 15:00,11,6,5,176,75,101,64,40,24,73,81
Sat 18 Jul 2020 16:00,15,10,5,140,57,83,49,35,14,70,91
Sat 18 Jul 2020 17:00,14,5,9,134,52,82,63,37,26,97,79
Sat 18 Jul 2020 18:00,7,5,2,156,85,71,62,40,22,93,81
Sat 18 Jul 2020 19:00,10,4,6,123,58,65,44,32,12,72,55
Sat 18 Jul 2020 20:00,4,3,1,107,56,51,36,23,13,60,54
Sat 18 Jul 2020 21:00,9,4,5,89,51,38,33,18,15,59,36
Sat 18 Jul 2020 22:00,3,2,1,84,52,32,31,15,16,45,28
Sat 18 Jul 2020 23:00,0,0,0,47,36,11,20,10,10,53,18
Sun 19 Jul 2020 00:00,4,2,2,34,24,10,14,3,11,27,7
Sun 19 Jul 2020 01:00,1,0,1,23,16,7,6,4,2,18,4
Sun 19 Jul 2020 02:00,1,1,0,18,8,10,4,4,0,14,5
Sun 19 Jul 2020 03:00,0,0,0,9,7,2,1,1,0,4,4
Sun 19 Jul 2020 04:00,0,0,0,12,5,7,1,1,0,5,6
Sun 19 Jul 2020 05:00,1,1,0,8,3,5,3,2,1,1,5
Sun 19 Jul 2020 06:00,0,0,0,25,7,18,8,7,1,10,16
Sun 19 Jul 2020 07:00,1,1,0,52,19,33,22,18,4,15,20
Sun 19 Jul 2020 08:00,0,0,0,63,18,45,29,26,3,31,29
Sun 19 Jul 2020 09:00,4,1,3,74,24,50,33,25,8,33,35
Sun 19 Jul 2020 10:00,8,4,4,96,26,70,59,30,29,73,48
Sun 19 Jul 2020 11:00,4,4,0,150,50,100,62,37,25,62,48
Sun 19 Jul 2020 12:00,12,6,6,136,48,88,69,45,24,79,65
Sun 19 Jul 2020 13:00,23,16,7,191,85,106,86,52,34,82,75
Sun 19 Jul 2020 14:00,13,11,2,159,68,91,73,45,28,89,68
Sun 19 Jul 2020 15:00,5,2,3,129,56,73,82,40,42,76,72
Sun 19 Jul 2020 16:00,11,7,4,129,64,65,45,27,18,85,80
Sun 19 Jul 2020 17:00,14,7,7,138,61,77,62,35,27,68,63
Sun 19 Jul 2020 18:00,9,5,4,141,66,75,70,42,28,97,53
Sun 19 Jul 2020 19:00,13,8,5,141,73,68,67,37,30,68,52
Sun 19 Jul 2020 20:00,7,3,4,141,79,62,45,21,24,44,56
Sun 19 Jul 2020 21:00,5,4,1,90,55,35,35,19,16,50,56
Sun 19 Jul 2020 22:00,4,2,2,64,46,18,29,16,13,36,30
Sun 19 Jul 2020 23:00,2,2,0,29,22,7,20,7,13,27,17
Mon 20 Jul 2020 00:00,2,2,0,15,7,8,4,1,3,16,2
Mon 20 Jul 2020 01:00,1,1,0,6,4,2,1,1,0,5,0
Mon 20 Jul 2020 02:00,0,0,0,5,5,0,1,0,1,3,0
Mon 20 Jul 2020 03:00,0,0,0,4,3,1,1,1,0,2,1
Mon 20 Jul 2020 04:00,2,2,0,12,4,8,2,2,0,5,5
Mon 20 Jul 2020 05:00,2,0,2,28,4,24,11,10,1,3,19
Mon 20 Jul 2020 06:00,5,5,0,97,15,82,83,75,8,16,73
Mon 20 Jul 2020 07:00,5,2,3,184,52,132,101,79,22,28,122
Mon 20 Jul 2020 08:00,10,7,3,259,67,192,107,100,7,39,170
Mon 20 Jul 2020 09:00,8,7,1,139,26,113,60,44,16,30,91
Mon 20 Jul 2020 10:00,6,3,3,114,39,75,43,32,11,28,73
Mon 20 Jul 2020 11:00,0,0,0,106,41,65,44,30,14,48,61
Mon 20 Jul 2020 12:00,8,4,4,118,45,73,32,29,3,48,43
Mon 20 Jul 2020 13:00,16,11,5,134,67,67,62,45,17,65,68
Mon 20 Jul 2020 14:00,8,5,3,131,56,75,48,29,19,71,77
Mon 20 Jul 2020 15:00,10,5,5,133,67,66,56,22,34,99,56
Mon 20 Jul 2020 16:00,10,8,2,186,99,87,64,32,32,152,62
Mon 20 Jul 2020 17:00,8,4,4,286,160,126,104,63,41,205,60
Mon 20 Jul 2020 18:00,13,7,6,270,143,127,103,69,34,170,40
Mon 20 Jul 2020 19:00,13,9,4,188,93,95,62,39,23,103,69
Mon 20 Jul 2020 20:00,13,7,6,132,68,64,63,33,30,70,50
Mon 20 Jul 2020 21:00,9,4,5,93,59,34,40,23,17,37,21
Mon 20 Jul 2020 22:00,8,8,0,54,32,22,44,21,23,44,24
Mon 20 Jul 2020 23:00,1,0,1,30,16,14,16,9,7,22,8
Tue 21 Jul 2020 00:00,1,1,0,14,8,6,6,3,3,13,14
Tue 21 Jul 2020 01:00,0,0,0,6,6,0,3,1,2,4,1
Tue 21 Jul 2020 02:00,0,0,0,5,1,4,1,1,0,5,1
Tue 21 Jul 2020 03:00,0,0,0,5,1,4,1,1,0,2,1
Tue 21 Jul 2020 04:00,1,0,1,12,3,9,2,2,0,4,3
Tue 21 Jul 2020 05:00,2,2,0,26,7,19,12,12,0,5,12
Tue 21 Jul 2020 06:00,8,7,1,104,15,89,86,76,10,10,76
Tue 21 Jul 2020 07:00,7,2,5,223,69,154,126,102,24,31,155
Tue 21 Jul 2020 08:00,10,7,3,302,85,217,112,102,10,33,198
Tue 21 Jul 2020 09:00,8,6,2,172,26,146,55,44,11,38,101
Tue 21 Jul 2020 10:00,5,3,2,106,35,71,32,26,6,40,71
Tue 21 Jul 2020 11:00,11,9,2,133,61,72,47,39,8,45,66
Tue 21 Jul 2020 12:00,4,2,2,142,50,92,57,38,19,51,59
Tue 21 Jul 2020 13:00,12,9,3,152,68,84,57,35,22,65,66
Tue 21 Jul 2020 14:00,6,4,2,145,71,74,57,40,17,81,71
Tue 21 Jul 2020 15:00,7,3,4,163,83,80,58,30,28,103,47
Tue 21 Jul 2020 16:00,9,7,2,176,102,74,89,49,40,136,75
Tue 21 Jul 2020 17:00,14,9,5,314,168,146,124,68,56,240,67
Tue 21 Jul 2020 18:00,18,6,12,299,171,128,127,67,60,196,87
Tue 21 Jul 2020 19:00,16,10,6,218,111,107,63,42,21,150,53
Tue 21 Jul 2020 20:00,7,3,4,163,92,71,49,28,21,86,45
Tue 21 Jul 2020 21:00,5,3,2,120,69,51,43,27,16,39,38
Tue 21 Jul 2020 22:00,4,2,2,67,39,28,30,15,15,50,16
Tue 21 Jul 2020 23:00,4,2,2,42,31,11,15,5,10,22,8
Wed 22 Jul 2020 00:00,1,1,0,21,15,6,6,2,4,18,10
Wed 22 Jul 2020 01:00,0,0,0,11,7,4,6,4,2,8,2
Wed 22 Jul 2020 02:00,0,0,0,6,2,4,0,0,0,2,2
Wed 22 Jul 2020 03:00,0,0,0,4,2,2,0,0,0,2,0
Wed 22 Jul 2020 04:00,1,0,1,9,3,6,3,3,0,3,4
Wed 22 Jul 2020 05:00,1,1,0,19,2,17,8,6,2,4,12
Wed 22 Jul 2020 06:00,4,4,0,89,19,70,58,52,6,10,54
Wed 22 Jul 2020 07:00,6,3,3,160,45,115,87,68,19,23,106
Wed 22 Jul 2020 08:00,6,4,2,266,58,208,102,89,13,27,162
Wed 22 Jul 2020 09:00,6,4,2,129,25,104,42,35,7,24,80
Wed 22 Jul 2020 10:00,5,4,1,90,28,62,24,20,4,23,54
Wed 22 Jul 2020 11:00,5,4,1,101,38,63,36,24,12,34,29
Wed 22 Jul 2020 12:00,4,2,2,128,48,80,61,42,19,38,61
Wed 22 Jul 2020 13:00,7,3,4,119,48,71,42,30,12,68,60
Wed 22 Jul 2020 14:00,3,2,1,106,50,56,33,14,19,62,38
Wed 22 Jul 2020 15:00,11,6,5,127,60,67,45,25,20,75,52
Wed 22 Jul 2020 16:00,14,8,6,175,99,76,73,35,38,115,54
Wed 22 Jul 2020 17:00,17,10,7,300,177,123,89,41,48,185,75
Wed 22 Jul 2020 18:00,9,6,3,223,121,102,79,47,32,193,77
Wed 22 Jul 2020 19:00,5,3,2,163,80,83,56,29,27,89,59
Wed 22 Jul 2020 20:00,4,2,2,128,69,59,61,36,25,59,50
Wed 22 Jul 2020 21:00,3,3,0,92,63,29,30,11,19,42,39
Wed 22 Jul 2020 22:00,8,4,4,56,41,15,33,15,18,37,21
Wed 22 Jul 2020 23:00,0,0,0,49,29,20,17,7,10,34,14
Thu 23 Jul 2020 00:00,2,2,0,20,11,9,5,1,4,19,7
Thu 23 Jul 2020 01:00,1,0,1,8,5,3,2,2,0,6,4
Thu 23 Jul 2020 02:00,0,0,0,6,4,2,1,1,0,4,0
Thu 23 Jul 2020 03:00,1,0,1,4,1,3,3,2,1,2,0
Thu 23 Jul 2020 04:00,2,0,2,10,4,6,1,1,0,1,4
Thu 23 Jul 2020 05:00,1,1,0,23,2,21,12,10,2,3,17
Thu 23 Jul 2020 06:00,6,4,2,95,22,73,74,65,9,11,70
Thu 23 Jul 2020 07:00,4,1,3,173,48,125,82,74,8,21,92
Thu 23 Jul 2020 08:00,4,4,0,235,50,185,99,83,16,31,140
Thu 23 Jul 2020 09:00,2,2,0,126,33,93,47,40,7,15,85
Thu 23 Jul 2020 10:00,3,2,1,69,22,47,31,24,7,16,41
Thu 23 Jul 2020 11:00,7,6,1,96,24,72,39,29,10,22,31
Thu 23 Jul 2020 12:00,4,2,2,116,40,76,42,27,15,39,34
Thu 23 Jul 2020 13:00,8,4,4,137,63,74,50,33,17,55,48
Thu 23 Jul 2020 14:00,11,4,7,110,54,56,42,25,17,54,48
Thu 23 Jul 2020 15:00,14,9,5,151,83,68,44,23,21,77,38
Thu 23 Jul 2020 16:00,13,10,3,168,95,73,84,50,34,102,51
Thu 23 Jul 2020 17:00,10,4,6,267,146,121,98,52,46,178,73
Thu 23 Jul 2020 18:00,12,6,6,240,115,125,104,60,44,153,48
Thu 23 Jul 2020 19:00,18,6,12,191,92,99,61,39,22,90,45
Thu 23 Jul 2020 20:00,4,1,3,154,89,65,42,15,27,59,53
Thu 23 Jul 2020 21:00,3,2,1,124,73,51,34,18,16,45,32
Thu 23 Jul 2020 22:00,4,4,0,74,52,22,39,20,19,50,33
Thu 23 Jul 2020 23:00,4,2,2,48,33,15,17,5,12,30,5
Fri 24 Jul 2020 00:00,0,0,0,34,22,12,8,3,5,15,7
Fri 24 Jul 2020 01:00,0,0,0,14,6,8,3,3,0,6,4
Fri 24 Jul 2020 02:00,0,0,0,5,3,2,3,3,0,4,1
Fri 24 Jul 2020 03:00,0,0,0,2,0,2,1,1,0,1,1
Fri 24 Jul 2020 04:00,2,0,2,9,4,5,4,3,1,3,5
Fri 24 Jul 2020 05:00,1,1,0,23,3,20,9,6,3,7,12
Fri 24 Jul 2020 06:00,5,5,0,111,17,94,67,61,6,16,70
Fri 24 Jul 2020 07:00,4,2,2,185,58,127,109,86,23,25,99
Fri 24 Jul 2020 08:00,4,4,0,251,67,184,84,76,8,32,163
Fri 24 Jul 2020 09:00,5,3,2,139,42,97,56,45,11,29,87
Fri 24 Jul 2020 10:00,1,1,0,95,33,62,38,30,8,32,61
Fri 24 Jul 2020 11:00,4,2,2,111,33,78,48,37,11,47,52
Fri 24 Jul 2020 12:00,10,4,6,116,41,75,44,32,12,45,56
Fri 24 Jul 2020 13:00,10,6,4,167,76,91,86,50,36,67,49
Fri 24 Jul 2020 14:00,6,4,2,168,86,82,47,27,20,93,66
Fri 24 Jul 2020 15:00,7,3,4,153,101,52,59,34,25,96,52
Fri 24 Jul 2020 16:00,10,5,5,144,79,65,54,28,26,103,43
Fri 24 Jul 2020 17:00,8,3,5,207,101,106,59,25,34,121,37
Fri 24 Jul 2020 18:00,8,4,4,162,83,79,55,33,22,117,25
Fri 24 Jul 2020 19:00,11,4,7,161,83,78,65,38,27,84,46
Fri 24 Jul 2020 20:00,6,2,4,131,65,66,50,33,17,66,51
Fri 24 Jul 2020 21:00,2,1,1,98,51,47,55,28,27,37,26
Fri 24 Jul 2020 22:00,5,2,3,45,29,16,25,15,10,39,24
Fri 24 Jul 2020 23:00,0,0,0,49,35,14,14,5,9,30,17
Sat 25 Jul 2020 00:00,0,0,0,21,13,8,15,4,11,16,6
Sat 25 Jul 2020 01:00,1,1,0,11,8,3,5,4,1,9,4
Sat 25 Jul 2020 02:00,0,0,0,15,10,5,1,1,0,10,2
Sat 25 Jul 2020 03:00,1,1,0,11,6,5,3,0,3,2,0
Sat 25 Jul 2020 04:00,0,0,0,8,5,3,2,1,1,2,2
Sat 25 Jul 2020 05:00,1,1,0,7,2,5,4,4,0,2,9
Sat 25 Jul 2020 06:00,0,0,0,43,8,35,19,18,1,9,16
Sat 25 Jul 2020 07:00,5,4,1,58,15,43,30,25,5,14,25
Sat 25 Jul 2020 08:00,7,3,4,86,30,56,33,28,5,14,37
Sat 25 Jul 2020 09:00,5,3,2,84,37,47,37,31,6,31,53
Sat 25 Jul 2020 10:00,5,3,2,92,23,69,45,29,16,41,50
Sat 25 Jul 2020 11:00,9,7,2,115,39,76,46,31,15,41,51
Sat 25 Jul 2020 12:00,11,8,3,108,36,72,46,27,19,56,49
Sat 25 Jul 2020 13:00,9,6,3,150,56,94,54,29,25,82,57
Sat 25 Jul 2020 14:00,11,8,3,134,58,76,71,43,28,89,66
Sat 25 Jul 2020 15:00,7,4,3,103,47,56,56,40,16,58,67
Sat 25 Jul 2020 16:00,13,9,4,116,50,66,50,31,19,57,60
Sat 25 Jul 2020 17:00,2,0,2,92,53,39,32,21,11,38,24
Sat 25 Jul 2020 18:00,4,2,2,105,56,49,43,29,14,61,31
Sat 25 Jul 2020 19:00,10,5,5,115,54,61,42,27,15,58,39
Sat 25 Jul 2020 20:00,3,3,0,98,44,54,28,22,6,38,45
Sat 25 Jul 2020 21:00,4,2,2,68,33,35,32,22,10,34,32
Sat 25 Jul 2020 22:00,6,4,2,64,36,28,26,12,14,40,28
Sat 25 Jul 2020 23:00,0,0,0,42,24,18,20,8,12,41,23
Sun 26 Jul 2020 00:00,1,1,0,39,26,13,9,2,7,16,12
Sun 26 Jul 2020 01:00,0,0,0,9,6,3,5,1,4,8,4
Sun 26 Jul 2020 02:00,1,0,1,8,6,2,1,1,0,14,6
Sun 26 Jul 2020 03:00,0,0,0,12,6,6,1,0,1,3,0
Sun 26 Jul 2020 04:00,2,0,2,3,1,2,2,2,0,8,3
Sun 26 Jul 2020 05:00,1,1,0,8,3,5,4,2,2,3,7
Sun 26 Jul 2020 06:00,1,1,0,21,6,15,11,10,1,8,11
Sun 26 Jul 2020 07:00,3,2,1,37,11,26,26,21,5,20,22
Sun 26 Jul 2020 08:00,1,1,0,68,32,36,25,19,6,17,27
Sun 26 Jul 2020 09:00,5,2,3,66,20,46,27,21,6,25,49
Sun 26 Jul 2020 10:00,11,7,4,101,35,66,41,30,11,38,56
Sun 26 Jul 2020 11:00,10,6,4,111,39,72,50,36,14,55,58
Sun 26 Jul 2020 12:00,15,10,5,105,38,67,61,39,22,75,61
Sun 26 Jul 2020 13:00,4,2,2,157,68,89,36,22,14,69,70
Sun 26 Jul 2020 14:00,10,5,5,112,53,59,64,32,32,56,62
Sun 26 Jul 2020 15:00,12,7,5,110,45,65,49,32,17,80,50
Sun 26 Jul 2020 16:00,7,4,3,117,54,63,50,38,12,70,76
Sun 26 Jul 2020 17:00,13,7,6,133,65,68,52,35,17,65,58
Sun 26 Jul 2020 18:00,2,1,1,117,61,56,57,39,18,62,58
Sun 26 Jul 2020 19:00,7,3,4,144,74,70,53,32,21,57,38
Sun 26 Jul 2020 20:00,13,7,6,90,50,40,46,31,15,40,36
Sun 26 Jul 2020 21:00,5,4,1,94,61,33,29,10,19,53,31
Sun 26 Jul 2020 22:00,3,1,2,39,28,11,25,8,17,32,5
Sun 26 Jul 2020 23:00,3,0,3,27,21,6,10,5,5,19,5
Mon 27 Jul 2020 00:00,2,0,2,12,7,5,3,2,1,7,1
Mon 27 Jul 2020 01:00,0,0,0,5,3,2,1,1,0,2,1
Mon 27 Jul 2020 02:00,0,0,0,3,1,2,0,0,0,1,0
Mon 27 Jul 2020 03:00,0,0,0,6,3,3,2,2,0,7,0
Mon 27 Jul 2020 04:00,0,0,0,4,3,1,1,1,0,0,3
Mon 27 Jul 2020 05:00,1,1,0,19,2,17,5,5,0,1,13
Mon 27 Jul 2020 06:00,5,5,0,83,14,69,52,48,4,6,50
Mon 27 Jul 2020 07:00,3,2,1,130,29,101,72,61,11,16,84
Mon 27 Jul 2020 08:00,10,6,4,209,61,148,79,70,9,19,124
Mon 27 Jul 2020 09:00,7,4,3,123,20,103,43,36,7,23,67
Mon 27 Jul 2020 10:00,2,1,1,75,31,44,24,21,3,12,36
Mon 27 Jul 2020 11:00,8,5,3,88,28,60,39,29,10,30,22
Mon 27 Jul 2020 12:00,1,1,0,101,34,67,46,32,14,33,44
Mon 27 Jul 2020 13:00,9,7,2,99,39,60,51,30,21,45,40
Mon 27 Jul 2020 14:00,5,5,0,92,45,47,34,22,12,56,42
Mon 27 Jul 2020 15:00,11,4,7,120,48,72,52,30,22,62,51
Mon 27 Jul 2020 16:00,13,7,6,157,78,79,53,29,24,94,47
Mon 27 Jul 2020 17:00,11,6,5,284,148,136,112,69,43,169,51
Mon 27 Jul 2020 18:00,15,11,4,225,122,103,82,47,35,159,55
Mon 27 Jul 2020 19:00,11,8,3,182,92,90,61,34,27,80,48
Mon 27 Jul 2020 20:00,13,6,7,104,56,48,43,19,24,57,27
Mon 27 Jul 2020 21:00,4,2,2,79,57,22,32,14,18,30,32
Mon 27 Jul 2020 22:00,1,1,0,48,35,13,28,13,15,41,15
Mon 27 Jul 2020 23:00,1,0,1,24,16,8,12,5,7,27,10
Tue 28 Jul 2020 00:00,0,0,0,10,5,5,3,3,0,8,9
Tue 28 Jul 2020 01:00,1,0,1,6,5,1,1,0,1,5,3
Tue 28 Jul 2020 02:00,0,0,0,4,1,3,0,0,0,8,0
Tue 28 Jul 2020 03:00,0,0,0,4,2,2,2,1,1,1,0
Tue 28 Jul 2020 04:00,1,0,1,6,2,4,1,1,0,4,3
Tue 28 Jul 2020 05:00,1,0,1,35,4,31,9,8,1,3,11
Tue 28 Jul 2020 06:00,5,4,1,106,17,89,78,72,6,14,77
Tue 28 Jul 2020 07:00,4,4,0,213,64,149,103,90,13,26,134
Tue 28 Jul 2020 08:00,13,8,5,261,65,196,97,88,9,37,185
Tue 28 Jul 2020 09:00,10,9,1,154,39,115,65,55,10,24,96
Tue 28 Jul 2020 10:00,6,5,1,97,33,64,24,22,2,23,70
Tue 28 Jul 2020 11:00,11,6,5,98,31,67,53,41,12,42,42
Tue 28 Jul 2020 12:00,14,6,8,114,37,77,59,34,25,45,44
Tue 28 Jul 2020 13:00,12,7,5,125,45,80,97,55,42,72,52
Tue 28 Jul 2020 14:00,9,5,4,144,63,81,92,48,44,49,48
Tue 28 Jul 2020 15:00,9,5,4,144,80,64,106,56,50,75,44
Tue 28 Jul 2020 16:00,15,7,8,197,98,99,121,57,64,141,64
Tue 28 Jul 2020 17:00,9,5,4,325,184,141,124,66,58,207,72
Tue 28 Jul 2020 18:00,12,8,4,282,150,132,83,51,32,197,69
Tue 28 Jul 2020 19:00,17,8,9,188,103,85,57,28,29,119,56
Tue 28 Jul 2020 20:00,9,3,6,125,72,53,45,21,24,61,51
Tue 28 Jul 2020 21:00,8,3,5,78,42,36,29,16,13,61,51
Tue 28 Jul 2020 22:00,3,1,2,63,51,12,39,18,21,32,23
Tue 28 Jul 2020 23:00,4,1,3,24,17,7,15,4,11,30,9
Wed 29 Jul 2020 00:00,0,0,0,15,12,3,6,4,2,7,9
Wed 29 Jul 2020 01:00,0,0,0,9,3,6,5,4,1,6,3
Wed 29 Jul 2020 02:00,0,0,0,8,3,5,2,0,2,4,2
Wed 29 Jul 2020 03:00,0,0,0,7,1,6,1,1,0,2,0
Wed 29 Jul 2020 04:00,0,0,0,12,2,10,1,1,0,0,3
Wed 29 Jul 2020 05:00,0,0,0,29,7,22,14,10,4,5,15
Wed 29 Jul 2020 06:00,6,5,1,115,19,96,65,60,5,9,72
Wed 29 Jul 2020 07:00,7,4,3,183,47,136,106,92,14,28,117
Wed 29 Jul 2020 08:00,15,11,4,284,67,217,103,98,5,35,184
Wed 29 Jul 2020 09:00,12,9,3,163,39,124,59,51,8,38,114
Wed 29 Jul 2020 10:00,3,3,0,90,26,64,24,17,7,23,54
Wed 29 Jul 2020 11:00,8,6,2,86,20,66,53,35,18,34,40
Wed 29 Jul 2020 12:00,11,7,4,116,38,78,92,51,41,53,61
Wed 29 Jul 2020 13:00,9,7,2,124,53,71,87,60,27,62,56
Wed 29 Jul 2020 14:00,8,6,2,104,54,50,64,32,32,64,53
Wed 29 Jul 2020 15:00,10,5,5,120,67,53,52,27,25,89,54
Wed 29 Jul 2020 16:00,15,9,6,177,99,78,49,28,21,130,47
Wed 29 Jul 2020 17:00,8,6,2,283,176,107,113,57,56,168,37
Wed 29 Jul 2020 18:00,15,6,9,262,146,116,82,47,35,154,54
Wed 29 Jul 2020 19:00,9,4,5,168,77,91,53,31,22,99,45
Wed 29 Jul 2020 20:00,5,1,4,118,60,58,51,29,22,65,61
Wed 29 Jul 2020 21:00,4,3,1,95,59,36,37,18,19,54,21
Wed 29 Jul 2020 22:00,2,2,0,57,41,16,26,13,13,26,22
Wed 29 Jul 2020 23:00,1,0,1,45,33,12,12,3,9,34,8
Thu 30 Jul 2020 00:00,0,0,0,23,18,5,7,2,5,22,4
Thu 30 Jul 2020 01:00,0,0,0,11,6,5,4,2,2,2,3
Thu 30 Jul 2020 02:00,0,0,0,3,1,2,0,0,0,6,2
Thu 30 Jul 2020 03:00,1,0,1,4,1,3,1,1,0,1,2
Thu 30 Jul 2020 04:00,0,0,0,7,1,6,2,1,1,0,4
Thu 30 Jul 2020 05:00,0,0,0,29,4,25,10,7,3,3,9
Thu 30 Jul 2020 06:00,5,5,0,93,12,81,58,50,8,9,45
Thu 30 Jul 2020 07:00,8,6,2,164,47,117,88,77,11,16,94
Thu 30 Jul 2020 08:00,10,8,2,269,60,209,99,91,8,29,173
Thu 30 Jul 2020 09:00,6,5,1,158,41,117,57,50,7,18,81
Thu 30 Jul 2020 10:00,2,2,0,97,27,70,40,32,8,26,61
Thu 30 Jul 2020 11:00,6,3,3,104,34,70,42,27,15,43,47
Thu 30 Jul 2020 12:00,5,3,2,117,36,81,68,47,21,54,69
Thu 30 Jul 2020 13:00,6,4,2,136,67,69,54,39,15,65,63
Thu 30 Jul 2020 14:00,8,6,2,137,58,79,48,26,22,72,49
Thu 30 Jul 2020 15:00,6,4,2,130,65,65,58,30,28,67,41
Thu 30 Jul 2020 16:00,16,9,7,181,93,88,68,37,31,120,60
Thu 30 Jul 2020 17:00,7,4,3,299,183,116,183,86,97,188,86
Thu 30 Jul 2020 18:00,12,7,5,257,133,124,203,100,103,162,55
Thu 30 Jul 2020 19:00,11,5,6,201,104,97,157,95,62,107,47
Thu 30 Jul 2020 20:00,13,5,8,151,80,71,151,79,72,69,63
Thu 30 Jul 2020 21:00,8,4,4,110,62,48,105,58,47,60,40
Thu 30 Jul 2020 22:00,6,4,2,61,47,14,40,22,18,50,27
Thu 30 Jul 2020 23:00,1,0,1,50,36,14,21,7,14,43,11
Fri 31 Jul 2020 00:00,3,2,1,26,20,6,16,9,7,18,6
Fri 31 Jul 2020 01:00,1,1,0,7,6,1,3,2,1,14,2
Fri 31 Jul 2020 02:00,0,0,0,10,7,3,0,0,0,5,0
Fri 31 Jul 2020 03:00,1,0,1,5,2,3,0,0,0,1,2
Fri 31 Jul 2020 04:00,0,0,0,5,3,2,3,3,0,4,3
Fri 31 Jul 2020 05:00,0,0,0,29,10,19,10,9,1,10,17
Fri 31 Jul 2020 06:00,3,3,0,88,11,77,80,70,10,12,70
Fri 31 Jul 2020 07:00,5,3,2,179,55,124,85,75,10,34,99
Fri 31 Jul 2020 08:00,12,9,3,234,64,170,100,81,19,27,143
Fri 31 Jul 2020 09:00,10,6,4,146,32,114,60,50,10,32,78
Fri 31 Jul 2020 10:00,10,7,3,109,23,86,66,51,15,40,59
Fri 31 Jul 2020 11:00,7,3,4,126,45,81,60,38,22,49,48
Fri 31 Jul 2020 12:00,9,6,3,101,44,57,68,34,34,55,49
Fri 31 Jul 2020 13:00,13,7,6,144,70,74,64,41,23,78,49
Fri 31 Jul 2020 14:00,7,6,1,154,69,85,75,35,40,74,54
Fri 31 Jul 2020 15:00,11,4,7,136,64,72,80,54,26,94,39
Fri 31 Jul 2020 16:00,18,12,6,188,82,106,68,42,26,100,61
Fri 31 Jul 2020 17:00,15,9,6,231,133,98,134,74,60,154,89
Fri 31 Jul 2020 18:00,15,9,6,222,117,105,101,55,46,148,63
Fri 31 Jul 2020 19:00,20,14,6,205,93,112,107,68,39,87,68
Fri 31 Jul 2020 20:00,29,16,13,142,62,80,75,50,25,62,56
Fri 31 Jul 2020 21:00,10,3,7,132,65,67,58,32,26,68,46
Fri 31 Jul 2020 22:00,9,3,6,84,57,27,43,15,28,51,27
Fri 31 Jul 2020 23:00,6,2,4,53,39,14,19,4,15,43,15
Sat 1 Aug 2020 00:00,0,0,0,45,31,14,9,2,7,32,10
Sat 1 Aug 2020 01:00,1,0,1,19,14,5,5,0,5,8,7
Sat 1 Aug 2020 02:00,0,0,0,13,8,5,2,1,1,7,5
Sat 1 Aug 2020 03:00,1,0,1,7,4,3,2,2,0,4,0
Sat 1 Aug 2020 04:00,0,0,0,11,5,6,1,1,0,4,2
Sat 1 Aug 2020 05:00,0,0,0,12,3,9,3,2,1,3,6
Sat 1 Aug 2020 06:00,1,0,1,35,9,26,27,24,3,9,16
Sat 1 Aug 2020 07:00,4,2,2,44,12,32,24,16,8,18,29
Sat 1 Aug 2020 08:00,7,4,3,65,24,41,40,34,6,29,51
Sat 1 Aug 2020 09:00,6,3,3,85,27,58,56,35,21,43,60
Sat 1 Aug 2020 10:00,14,6,8,115,33,82,73,47,26,51,73
Sat 1 Aug 2020 11:00,18,16,2,132,44,88,57,31,26,83,53
Sat 1 Aug 2020 12:00,16,15,1,138,42,96,89,56,33,77,62
Sat 1 Aug 2020 13:00,28,18,10,134,56,78,92,64,28,73,53
Sat 1 Aug 2020 14:00,24,9,15,139,59,80,77,43,34,78,74
Sat 1 Aug 2020 15:00,23,10,13,114,62,52,90,55,35,66,46
Sat 1 Aug 2020 16:00,16,6,10,128,56,72,96,52,44,55,53
Sat 1 Aug 2020 17:00,12,7,5,120,54,66,74,40,34,59,56
Sat 1 Aug 2020 18:00,18,13,5,99,49,50,63,37,26,65,57
Sat 1 Aug 2020 19:00,2,1,1,107,54,53,45,28,17,59,40
Sat 1 Aug 2020 20:00,5,3,2,97,53,44,43,23,20,39,25
Sat 1 Aug 2020 21:00,12,5,7,62,32,30,28,16,12,46,35
Sat 1 Aug 2020 22:00,4,1,3,53,35,18,32,18,14,31,22
Sat 1 Aug 2020 23:00,2,1,1,37,28,9,28,13,15,24,16
Sun 2 Aug 2020 00:00,1,1,0,34,26,8,11,0,11,18,12
Sun 2 Aug 2020 01:00,1,1,0,11,7,4,2,1,1,13,4
Sun 2 Aug 2020 02:00,0,0,0,10,9,1,0,0,0,5,5
Sun 2 Aug 2020 03:00,0,0,0,4,2,2,1,1,0,9,0
Sun 2 Aug 2020 04:00,1,0,1,13,6,7,0,0,0,3,2
Sun 2 Aug 2020 05:00,0,0,0,14,3,11,2,2,0,6,3
Sun 2 Aug 2020 06:00,3,3,0,23,7,16,16,13,3,8,17
Sun 2 Aug 2020 07:00,2,2,0,38,11,27,20,17,3,17,16
Sun 2 Aug 2020 08:00,2,1,1,54,10,44,35,30,5,22,40
Sun 2 Aug 2020 09:00,10,5,5,66,18,48,47,39,8,36,30
Sun 2 Aug 2020 10:00,10,8,2,91,19,72,65,38,27,46,47
Sun 2 Aug 2020 11:00,19,11,8,103,33,70,78,53,25,43,41
Sun 2 Aug 2020 12:00,13,6,7,106,33,73,87,53,34,57,45
Sun 2 Aug 2020 13:00,20,14,6,127,54,73,113,68,45,87,76
Sun 2 Aug 2020 14:00,21,12,9,105,34,71,94,52,42,69,48
Sun 2 Aug 2020 15:00,30,19,11,117,58,59,109,69,40,79,72
Sun 2 Aug 2020 16:00,23,14,9,114,58,56,126,65,61,70,57
Sun 2 Aug 2020 17:00,22,7,15,96,43,53,73,41,32,65,52
Sun 2 Aug 2020 18:00,10,6,4,114,60,54,54,34,20,72,66
Sun 2 Aug 2020 19:00,14,2,12,115,57,58,60,33,27,45,60
Sun 2 Aug 2020 20:00,10,6,4,72,43,29,60,32,28,48,38
Sun 2 Aug 2020 21:00,7,3,4,59,35,24,34,17,17,42,31
Sun 2 Aug 2020 22:00,4,3,1,46,24,22,25,11,14,28,16
Sun 2 Aug 2020 23:00,2,1,1,30,18,12,13,7,6,34,9
Mon 3 Aug 2020 00:00,0,0,0,22,14,8,10,3,7,9,7
Mon 3 Aug 2020 01:00,0,0,0,3,1,2,3,1,2,9,2
Mon 3 Aug 2020 02:00,0,0,0,6,4,2,1,1,0,2,2
Mon 3 Aug 2020 03:00,0,0,0,7,5,2,0,0,0,2,2
Mon 3 Aug 2020 04:00,1,0,1,8,4,4,0,0,0,1,1
Mon 3 Aug 2020 05:00,1,1,0,7,3,4,0,0,0,0,6
Mon 3 Aug 2020 06:00,1,1,0,29,5,24,23,22,1,7,17
Mon 3 Aug 2020 07:00,1,1,0,46,10,36,33,28,5,10,25
Mon 3 Aug 2020 08:00,3,2,1,47,13,34,24,19,5,20,35
Mon 3 Aug 2020 09:00,5,2,3,59,25,34,49,26,23,33,37
Mon 3 Aug 2020 10:00,9,4,5,71,25,46,60,42,18,42,49
Mon 3 Aug 2020 11:00,20,7,13,106,37,69,85,63,22,51,74
Mon 3 Aug 2020 12:00,32,15,17,115,43,72,128,61,67,89,72
Mon 3 Aug 2020 13:00,29,17,12,103,43,60,111,70,41,71,74
Mon 3 Aug 2020 14:00,12,9,3,118,49,69,123,75,48,66,96
Mon 3 Aug 2020 15:00,29,17,12,108,52,56,116,59,57,92,72
Mon 3 Aug 2020 16:00,31,15,16,115,57,58,108,58,50,89,65
Mon 3 Aug 2020 17:00,20,4,16,149,63,86,76,38,38,92,68
Mon 3 Aug 2020 18:00,11,6,5,122,65,57,81,49,32,74,65
Mon 3 Aug 2020 19:00,20,9,11,113,61,52,69,41,28,58,59
Mon 3 Aug 2020 20:00,12,6,6,88,49,39,58,33,25,58,44
Mon 3 Aug 2020 21:00,8,6,2,77,38,39,32,19,13,35,27
Mon 3 Aug 2020 22:00,4,4,0,45,31,14,22,10,12,19,11
Mon 3 Aug 2020 23:00,1,1,0,28,17,11,11,3,8,28,7
Tue 4 Aug 2020 00:00,0,0,0,14,9,5,4,1,3,12,3
Tue 4 Aug 2020 01:00,2,1,1,8,3,5,2,0,2,3,1
Tue 4 Aug 2020 02:00,0,0,0,5,3,2,0,0,0,3,2
Tue 4 Aug 2020 03:00,0,0,0,3,1,2,0,0,0,1,0
Tue 4 Aug 2020 04:00,2,1,1,7,4,3,3,3,0,0,8
Tue 4 Aug 2020 05:00,1,1,0,21,3,18,8,8,0,6,17
Tue 4 Aug 2020 06:00,7,6,1,87,16,71,70,62,8,10,72
Tue 4 Aug 2020 07:00,7,7,0,171,43,128,91,76,15,27,96
Tue 4 Aug 2020 08:00,13,7,6,247,60,187,99,90,9,28,156
Tue 4 Aug 2020 09:00,6,5,1,121,30,91,73,63,10,28,80
Tue 4 Aug 2020 10:00,5,4,1,78,35,43,31,24,7,28,54
Tue 4 Aug 2020 11:00,6,4,2,90,30,60,56,44,12,43,44
Tue 4 Aug 2020 12:00,18,10,8,108,45,63,51,39,12,53,50
Tue 4 Aug 2020 13:00,12,7,5,113,53,60,67,44,23,68,41
Tue 4 Aug 2020 14:00,14,9,5,106,45,61,59,39,20,72,46
Tue 4 Aug 2020 15:00,14,8,6,121,55,66,66,34,32,77,43
Tue 4 Aug 2020 16:00,19,8,11,174,88,86,77,42,35,133,51
Tue 4 Aug 2020 17:00,22,13,9,263,155,108,105,43,62,176,56
Tue 4 Aug 2020 18:00,29,16,13,233,128,105,122,77,45,170,72
Tue 4 Aug 2020 19:00,8,5,3,168,87,81,89,57,32,80,47
Tue 4 Aug 2020 20:00,15,7,8,114,64,50,76,34,42,58,41
Tue 4 Aug 2020 21:00,12,6,6,107,64,43,51,27,24,46,24
Tue 4 Aug 2020 22:00,3,2,1,54,37,17,25,9,16,45,21
Tue 4 Aug 2020 23:00,1,0,1,31,23,8,12,1,11,22,9
Wed 5 Aug 2020 00:00,3,1,2,13,10,3,4,3,1,12,7
Wed 5 Aug 2020 01:00,1,0,1,10,6,4,2,2,0,10,4
Wed 5 Aug 2020 02:00,2,0,2,5,3,2,0,0,0,7,3
Wed 5 Aug 2020 03:00,0,0,0,6,3,3,0,0,0,0,1
Wed 5 Aug 2020 04:00,0,0,0,6,3,3,2,2,0,2,5
Wed 5 Aug 2020 05:00,0,0,0,25,5,20,12,10,2,5,18
Wed 5 Aug 2020 06:00,10,8,2,102,18,84,77,67,10,16,72
Wed 5 Aug 2020 07:00,9,8,1,180,45,135,99,82,17,26,116
Wed 5 Aug 2020 08:00,13,10,3,267,68,199,115,103,12,37,151
Wed 5 Aug 2020 09:00,7,5,2,143,33,110,52,47,5,21,82
Wed 5 Aug 2020 10:00,7,6,1,77,23,54,29,18,11,29,49
Wed 5 Aug 2020 11:00,7,6,1,84,28,56,49,35,14,24,36
Wed 5 Aug 2020 12:00,15,10,5,120,44,76,50,35,15,44,40
Wed 5 Aug 2020 13:00,10,7,3,101,40,61,48,29,19,51,33
Wed 5 Aug 2020 14:00,11,7,4,108,50,58,42,28,14,48,42
Wed 5 Aug 2020 15:00,9,5,4,117,56,61,69,41,28,85,48
Wed 5 Aug 2020 16:00,13,7,6,131,70,61,93,47,46,120,46
Wed 5 Aug 2020 17:00,21,13,8,284,160,124,104,47,57,184,65
Wed 5 Aug 2020 18:00,13,6,7,219,122,97,137,77,60,152,63
Wed 5 Aug 2020 19:00,12,8,4,168,80,88,95,50,45,85,44
Wed 5 Aug 2020 20:00,15,6,9,127,67,60,73,34,39,66,44
Wed 5 Aug 2020 21:00,7,2,5,106,59,47,53,27,26,71,35
Wed 5 Aug 2020 22:00,6,6,0,59,44,15,34,14,20,32,22
Wed 5 Aug 2020 23:00,3,1,2,47,34,13,15,5,10,37,15
Thu 6 Aug 2020 00:00,4,2,2,13,8,5,6,3,3,18,6
Thu 6 Aug 2020 01:00,1,1,0,6,5,1,2,2,0,3,0
Thu 6 Aug 2020 02:00,0,0,0,9,6,3,0,0,0,4,1
Thu 6 Aug 2020 03:00,1,0,1,5,2,3,2,1,1,0,0
Thu 6 Aug 2020 04:00,0,0,0,10,1,9,2,2,0,0,7
Thu 6 Aug 2020 05:00,1,1,0,26,5,21,12,11,1,4,23
Thu 6 Aug 2020 06:00,5,4,1,112,18,94,72,65,7,13,68
Thu 6 Aug 2020 07:00,8,7,1,195,54,141,104,85,19,32,123
Thu 6 Aug 2020 08:00,16,13,3,271,61,210,117,105,12,35,169
Thu 6 Aug 2020 09:00,14,11,3,147,30,117,70,62,8,27,98
Thu 6 Aug 2020 10:00,9,7,2,116,49,67,49,36,13,33,63
Thu 6 Aug 2020 11:00,6,3,3,112,26,86,64,47,17,39,55
Thu 6 Aug 2020 12:00,12,6,6,125,40,85,50,30,20,67,68
Thu 6 Aug 2020 13:00,14,6,8,125,48,77,77,43,34,70,68
Thu 6 Aug 2020 14:00,24,18,6,130,59,71,77,45,32,78,65
Thu 6 Aug 2020 15:00,16,8,8,133,74,59,66,36,30,97,71
Thu 6 Aug 2020 16:00,9,7,2,172,91,81,83,44,39,170,56
Thu 6 Aug 2020 17:00,22,13,9,292,169,123,131,77,54,166,83
Thu 6 Aug 2020 18:00,28,14,14,246,143,103,128,73,55,163,81
Thu 6 Aug 2020 19:00,25,12,13,200,94,106,97,59,38,119,70
Thu 6 Aug 2020 20:00,21,11,10,140,77,63,91,56,35,104,57
Thu 6 Aug 2020 21:00,12,3,9,104,70,34,42,23,19,55,48
Thu 6 Aug 2020 22:00,6,4,2,80,61,19,42,21,21,54,30
Thu 6 Aug 2020 23:00,7,1,6,44,31,13,14,4,10,41,16
Fri 7 Aug 2020 00:00,2,0,2,20,11,9,9,3,6,35,8
Fri 7 Aug 2020 01:00,0,0,0,12,12,0,3,3,0,6,3
Fri 7 Aug 2020 02:00,0,0,0,5,3,2,0,0,0,4,2
Fri 7 Aug 2020 03:00,2,2,0,4,2,2,0,0,0,1,1
Fri 7 Aug 2020 04:00,0,0,0,6,1,5,4,3,1,2,5
Fri 7 Aug 2020 05:00,1,1,0,24,5,19,10,9,1,6,19
Fri 7 Aug 2020 06:00,6,6,0,105,16,89,81,69,12,17,67
Fri 7 Aug 2020 07:00,5,3,2,169,47,122,108,91,17,26,125
Fri 7 Aug 2020 08:00,22,20,2,213,46,167,105,95,10,39,135
Fri 7 Aug 2020 09:00,10,4,6,152,37,115,55,48,7,22,77
Fri 7 Aug 2020 10:00,13,10,3,92,29,63,47,32,15,32,65
Fri 7 Aug 2020 11:00,10,6,4,95,25,70,69,54,15,30,49
Fri 7 Aug 2020 12:00,19,11,8,133,44,89,70,46,24,54,83
Fri 7 Aug 2020 13:00,15,8,7,131,60,71,76,45,31,88,66
Fri 7 Aug 2020 14:00,20,12,8,146,57,89,76,47,29,81,61
Fri 7 Aug 2020 15:00,11,7,4,170,78,92,86,39,47,99,60
Fri 7 Aug 2020 16:00,20,12,8,192,92,100,119,61,58,137,78
Fri 7 Aug 2020 17:00,25,18,7,286,158,128,134,56,78,178,78
Fri 7 Aug 2020 18:00,18,10,8,239,132,107,87,56,31,147,58
Fri 7 Aug 2020 19:00,17,6,11,208,94,114,91,60,31,100,63
Fri 7 Aug 2020 20:00,14,10,4,158,70,88,75,37,38,65,46
Fri 7 Aug 2020 21:00,7,4,3,115,68,47,37,17,20,52,23
Fri 7 Aug 2020 22:00,9,6,3,83,56,27,30,14,16,50,29
Fri 7 Aug 2020 23:00,2,2,0,73,49,24,27,9,18,41,22
Sat 8 Aug 2020 00:00,2,0,2,48,34,14,14,7,7,25,9
Sat 8 Aug 2020 01:00,1,1,0,19,12,7,7,2,5,8,11
Sat 8 Aug 2020 02:00,2,1,1,9,1,8,2,2,0,8,7
Sat 8 Aug 2020 03:00,1,1,0,12,8,4,0,0,0,13,3
Sat 8 Aug 2020 04:00,0,0,0,11,5,6,1,1,0,1,5
Sat 8 Aug 2020 05:00,1,1,0,14,5,9,5,3,2,10,10
Sat 8 Aug 2020 06:00,0,0,0,36,9,27,23,22,1,8,19
Sat 8 Aug 2020 07:00,3,3,0,68,15,53,49,39,10,28,45
Sat 8 Aug 2020 08:00,7,6,1,67,20,47,45,39,6,21,42
Sat 8 Aug 2020 09:00,6,4,2,97,36,61,54,37,17,44,66
Sat 8 Aug 2020 10:00,19,13,6,138,47,91,83,57,26,58,58
Sat 8 Aug 2020 11:00,18,13,5,138,45,93,91,50,41,93,55
Sat 8 Aug 2020 12:00,28,17,11,185,69,116,121,79,42,130,61
Sat 8 Aug 2020 13:00,34,20,14,178,73,105,137,75,62,115,75
Sat 8 Aug 2020 14:00,30,14,16,187,72,115,127,68,59,133,99
Sat 8 Aug 2020 15:00,23,13,10,166,60,106,124,73,51,118,75
Sat 8 Aug 2020 16:00,8,3,5,184,84,100,92,59,33,118,94
Sat 8 Aug 2020 17:00,12,6,6,167,78,89,71,37,34,110,107
Sat 8 Aug 2020 18:00,24,11,13,209,107,102,90,53,37,112,103
Sat 8 Aug 2020 19:00,20,8,12,164,88,76,83,40,43,92,106
Sat 8 Aug 2020 20:00,13,5,8,138,86,52,45,27,18,62,89
Sat 8 Aug 2020 21:00,7,1,6,107,59,48,37,17,20,61,57
Sat 8 Aug 2020 22:00,13,11,2,64,42,22,38,17,21,56,43
Sat 8 Aug 2020 23:00,1,0,1,49,34,15,21,14,7,51,21
Sun 9 Aug 2020 00:00,4,1,3,43,27,16,18,6,12,27,13
Sun 9 Aug 2020 01:00,0,0,0,22,15,7,5,3,2,6,10
Sun 9 Aug 2020 02:00,0,0,0,11,9,2,1,1,0,17,3
Sun 9 Aug 2020 03:00,0,0,0,5,4,1,0,0,0,6,3
Sun 9 Aug 2020 04:00,2,2,0,9,4,5,1,1,0,4,3
Sun 9 Aug 2020 05:00,0,0,0,13,3,10,3,2,1,2,5
Sun 9 Aug 2020 06:00,3,3,0,19,5,14,19,14,5,13,14
Sun 9 Aug 2020 07:00,1,1,0,36,12,24,25,13,12,19,29
Sun 9 Aug 2020 08:00,4,3,1,48,13,35,32,27,5,27,39
Sun 9 Aug 2020 09:00,6,3,3,94,27,67,50,38,12,23,40
Sun 9 Aug 2020 10:00,7,4,3,96,29,67,62,40,22,28,52
Sun 9 Aug 2020 11:00,14,7,7,96,35,61,93,50,43,69,38
Sun 9 Aug 2020 12:00,19,14,5,134,41,93,108,59,49,66,49
Sun 9 Aug 2020 13:00,20,12,8,135,65,70,80,49,31,108,49
Sun 9 Aug 2020 14:00,17,11,6,133,53,80,98,54,44,76,56
Sun 9 Aug 2020 15:00,21,11,10,135,59,76,112,73,39,75,50
Sun 9 Aug 2020 16:00,12,4,8,136,55,81,96,55,41,69,83
Sun 9 Aug 2020 17:00,16,5,11,141,83,58,58,23,35,76,49
Sun 9 Aug 2020 18:00,10,4,6,135,73,62,63,31,32,97,64
Sun 9 Aug 2020 19:00,12,9,3,121,67,54,64,39,25,62,49
Sun 9 Aug 2020 20:00,11,3,8,127,71,56,58,29,29,33,50
Sun 9 Aug 2020 21:00,7,6,1,87,52,35,38,20,18,44,44
Sun 9 Aug 2020 22:00,1,1,0,57,39,18,38,11,27,38,27
Sun 9 Aug 2020 23:00,1,0,1,33,23,10,14,6,8,23,10
Mon 10 Aug 2020 00:00,0,0,0,10,6,4,4,1,3,7,1
Mon 10 Aug 2020 01:00,1,0,1,9,7,2,3,3,0,6,1
Mon 10 Aug 2020 02:00,1,1,0,3,2,1,0,0,0,0,1
Mon 10 Aug 2020 03:00,1,0,1,7,4,3,0,0,0,1,0
Mon 10 Aug 2020 04:00,0,0,0,8,4,4,2,2,0,2,7
Mon 10 Aug 2020 05:00,1,1,0,23,0,23,10,10,0,5,20
Mon 10 Aug 2020 06:00,5,4,1,94,15,79,81,71,10,14,70
Mon 10 Aug 2020 07:00,13,11,2,167,38,129,104,90,14,22,125
Mon 10 Aug 2020 08:00,9,9,0,260,54,206,128,116,12,41,156
Mon 10 Aug 2020 09:00,13,11,2,126,23,103,66,57,9,24,85
Mon 10 Aug 2020 10:00,8,7,1,70,20,50,37,30,7,32,49
Mon 10 Aug 2020 11:00,10,5,5,83,30,53,54,46,8,32,42
Mon 10 Aug 2020 12:00,12,6,6,110,41,69,65,38,27,56,45
Mon 10 Aug 2020 13:00,14,10,4,109,50,59,60,33,27,72,52
Mon 10 Aug 2020 14:00,10,2,8,90,50,40,62,27,35,58,40
Mon 10 Aug 2020 15:00,5,3,2,84,44,40,54,24,30,68,27
Mon 10 Aug 2020 16:00,12,7,5,147,92,55,75,40,35,111,30
Mon 10 Aug 2020 17:00,17,7,10,246,145,101,102,38,64,168,41
Mon 10 Aug 2020 18:00,16,3,13,214,127,87,97,56,41,182,55
Mon 10 Aug 2020 19:00,12,7,5,135,76,59,72,42,30,80,34
Mon 10 Aug 2020 20:00,13,5,8,104,55,49,50,24,26,59,57
Mon 10 Aug 2020 21:00,9,6,3,69,48,21,42,20,22,37,27
Mon 10 Aug 2020 22:00,4,4,0,36,25,11,23,11,12,36,19
Mon 10 Aug 2020 23:00,1,1,0,27,22,5,5,3,2,13,12
Tue 11 Aug 2020 00:00,1,1,0,12,8,4,5,2,3,12,5
Tue 11 Aug 2020 01:00,1,0,1,5,4,1,2,2,0,0,3
Tue 11 Aug 2020 02:00,0,0,0,3,1,2,2,2,0,3,2
Tue 11 Aug 2020 03:00,0,0,0,3,1,2,1,1,0,0,0
Tue 11 Aug 2020 04:00,1,0,1,10,6,4,0,0,0,1,3
Tue 11 Aug 2020 05:00,3,2,1,20,2,18,8,8,0,6,19
Tue 11 Aug 2020 06:00,3,2,1,99,14,85,88,75,13,16,72
Tue 11 Aug 2020 07:00,17,15,2,199,51,148,117,98,19,29,118
Tue 11 Aug 2020 08:00,20,12,8,304,61,243,140,132,8,48,180
Tue 11 Aug 2020 09:00,11,9,2,152,30,122,69,62,7,23,92
Tue 11 Aug 2020 10:00,7,6,1,67,20,47,49,38,11,31,72
Tue 11 Aug 2020 11:00,7,2,5,72,33,39,42,26,16,37,50
Tue 11 Aug 2020 12:00,11,7,4,126,46,80,69,43,26,75,36
Tue 11 Aug 2020 13:00,14,9,5,134,61,73,69,44,25,72,57
Tue 11 Aug 2020 14:00,25,12,13,107,47,60,77,48,29,67,50
Tue 11 Aug 2020 15:00,18,7,11,134,60,74,88,41,47,80,61
Tue 11 Aug 2020 16:00,15,7,8,182,96,86,95,52,43,154,74
Tue 11 Aug 2020 17:00,22,9,13,278,177,101,136,66,70,199,72
Tue 11 Aug 2020 18:00,18,9,9,273,134,139,149,73,76,243,62
Tue 11 Aug 2020 19:00,14,7,7,165,92,73,90,48,42,131,64
Tue 11 Aug 2020 20:00,10,3,7,127,68,59,61,29,32,67,56
Tue 11 Aug 2020 21:00,8,2,6,114,66,48,47,17,30,53,47
Tue 11 Aug 2020 22:00,4,3,1,67,40,27,36,15,21,51,18
Tue 11 Aug 2020 23:00,5,1,4,40,28,12,7,2,5,25,12
Wed 12 Aug 2020 00:00,2,0,2,23,15,8,6,3,3,10,5
Wed 12 Aug 2020 01:00,3,2,1,11,9,2,3,3,0,6,1
Wed 12 Aug 2020 02:00,0,0,0,2,0,2,0,0,0,2,1
Wed 12 Aug 2020 03:00,1,0,1,4,2,2,1,0,1,4,1
Wed 12 Aug 2020 04:00,0,0,0,9,2,7,4,3,1,1,2
Wed 12 Aug 2020 05:00,0,0,0,23,5,18,14,10,4,8,24
Wed 12 Aug 2020 06:00,5,5,0,101,12,89,86,75,11,15,75
Wed 12 Aug 2020 07:00,7,5,2,194,55,139,125,105,20,35,140
Wed 12 Aug 2020 08:00,20,18,2,277,56,221,156,145,11,37,172
Wed 12 Aug 2020 09:00,12,8,4,174,42,132,90,77,13,33,110
Wed 12 Aug 2020 10:00,11,8,3,95,27,68,43,34,9,35,48
Wed 12 Aug 2020 11:00,13,9,4,103,31,72,61,41,20,44,45
Wed 12 Aug 2020 12:00,15,6,9,123,43,80,70,37,33,69,65
Wed 12 Aug 2020 13:00,25,21,4,128,62,66,95,60,35,84,50
Wed 12 Aug 2020 14:00,14,9,5,131,55,76,72,41,31,95,52
Wed 12 Aug 2020 15:00,15,6,9,144,62,82,97,47,50,108,50
Wed 12 Aug 2020 16:00,27,16,11,173,107,66,100,44,56,159,63
Wed 12 Aug 2020 17:00,32,11,21,346,194,152,140,63,77,233,70
Wed 12 Aug 2020 18:00,22,11,11,264,145,119,134,82,52,210,91
Wed 12 Aug 2020 19:00,19,8,11,219,111,108,77,41,36,130,65
Wed 12 Aug 2020 20:00,14,4,10,167,95,72,82,36,46,77,54
Wed 12 Aug 2020 21:00,20,8,12,128,74,54,64,39,25,66,54
Wed 12 Aug 2020 22:00,11,4,7,70,46,24,37,11,26,50,14
Wed 12 Aug 2020 23:00,4,2,2,50,34,16,22,8,14,43,17
Thu 13 Aug 2020 00:00,5,1,4,21,12,9,11,8,3,16,6
Thu 13 Aug 2020 01:00,0,0,0,14,9,5,3,2,1,5,2
Thu 13 Aug 2020 02:00,0,0,0,3,2,1,2,1,1,5,1
Thu 13 Aug 2020 03:00,0,0,0,7,4,3,1,0,1,5,1
Thu 13 Aug 2020 04:00,0,0,0,8,1,7,3,3,0,2,5
Thu 13 Aug 2020 05:00,1,1,0,24,2,22,13,12,1,8,13
Thu 13 Aug 2020 06:00,7,6,1,105,18,87,77,66,11,18,74
Thu 13 Aug 2020 07:00,8,5,3,191,48,143,117,98,19,37,116
Thu 13 Aug 2020 08:00,18,15,3,268,55,213,145,131,14,46,189
Thu 13 Aug 2020 09:00,16,11,5,141,31,110,83,74,9,28,87
Thu 13 Aug 2020 10:00,7,7,0,93,27,66,32,24,8,43,57
Thu 13 Aug 2020 11:00,14,8,6,95,32,63,74,54,20,31,53
Thu 13 Aug 2020 12:00,9,7,2,126,50,76,69,49,20,53,47
Thu 13 Aug 2020 13:00,7,4,3,139,59,80,65,49,16,81,78
Thu 13 Aug 2020 14:00,11,5,6,125,44,81,71,43,28,70,69
Thu 13 Aug 2020 15:00,10,7,3,137,63,74,84,43,41,95,65
Thu 13 Aug 2020 16:00,20,10,10,194,95,99,107,53,54,144,90
Thu 13 Aug 2020 17:00,30,12,18,312,186,126,158,71,87,236,89
Thu 13 Aug 2020 18:00,37,14,23,298,148,150,145,83,62,221,96
Thu 13 Aug 2020 19:00,25,11,14,243,125,118,142,64,78,123,70
Thu 13 Aug 2020 20:00,15,3,12,180,108,72,96,44,52,88,83
Thu 13 Aug 2020 21:00,10,7,3,132,71,61,77,36,41,61,42
Thu 13 Aug 2020 22:00,6,3,3,80,60,20,38,19,19,52,33
Thu 13 Aug 2020 23:00,1,1,0,61,39,22,28,11,17,57,15
Fri 14 Aug 2020 00:00,3,2,1,34,21,13,8,3,5,18,2
Fri 14 Aug 2020 01:00,0,0,0,16,9,7,5,4,1,11,3
Fri 14 Aug 2020 02:00,0,0,0,13,10,3,0,0,0,2,2
Fri 14 Aug 2020 03:00,0,0,0,7,2,5,0,0,0,4,1
Fri 14 Aug 2020 04:00,0,0,0,10,5,5,3,3,0,2,2
Fri 14 Aug 2020 05:00,3,3,0,26,5,21,13,13,0,5,23
Fri 14 Aug 2020 06:00,6,5,1,89,13,76,72,63,9,21,61
Fri 14 Aug 2020 07:00,7,6,1,185,44,141,106,88,18,38,110
Fri 14 Aug 2020 08:00,17,14,3,242,57,185,140,125,15,35,133
Fri 14 Aug 2020 09:00,13,8,5,146,40,106,54,45,9,31,98
Fri 14 Aug 2020 10:00,9,5,4,89,29,60,42,28,14,24,52
Fri 14 Aug 2020 11:00,8,5,3,98,38,60,52,41,11,43,54
Fri 14 Aug 2020 12:00,21,7,14,123,47,76,71,48,23,62,65
Fri 14 Aug 2020 13:00,11,4,7,173,73,100,84,47,37,76,60
Fri 14 Aug 2020 14:00,11,4,7,145,57,88,72,39,33,76,55
Fri 14 Aug 2020 15:00,15,10,5,172,89,83,77,40,37,90,43
Fri 14 Aug 2020 16:00,18,8,10,197,98,99,105,49,56,125,61
Fri 14 Aug 2020 17:00,18,10,8,249,143,106,134,61,73,166,73
Fri 14 Aug 2020 18:00,10,4,6,255,126,129,96,54,42,161,73
Fri 14 Aug 2020 19:00,13,4,9,238,116,122,91,56,35,108,83
Fri 14 Aug 2020 20:00,18,10,8,153,64,89,93,53,40,72,73
Fri 14 Aug 2020 21:00,8,5,3,113,62,51,50,26,24,73,36
Fri 14 Aug 2020 22:00,5,2,3,86,58,28,35,17,18,59,38
Fri 14 Aug 2020 23:00,3,2,1,83,53,30,26,8,18,53,10
Sat 15 Aug 2020 00:00,2,1,1,29,22,7,18,6,12,22,14
Sat 15 Aug 2020 01:00,1,0,1,25,20,5,4,3,1,17,5
Sat 15 Aug 2020 02:00,0,0,0,10,5,5,7,5,2,9,4
Sat 15 Aug 2020 03:00,0,0,0,6,4,2,3,1,2,8,1
Sat 15 Aug 2020 04:00,0,0,0,12,6,6,2,1,1,2,5
Sat 15 Aug 2020 05:00,1,1,0,16,6,10,7,7,0,4,10
Sat 15 Aug 2020 06:00,0,0,0,47,7,40,25,23,2,8,24
Sat 15 Aug 2020 07:00,2,2,0,52,12,40,40,32,8,20,39
Sat 15 Aug 2020 08:00,10,10,0,76,23,53,38,34,4,32,52
Sat 15 Aug 2020 09:00,7,3,4,84,32,52,57,47,10,27,53
Sat 15 Aug 2020 10:00,11,9,2,128,37,91,66,47,19,40,56
Sat 15 Aug 2020 11:00,12,8,4,132,51,81,50,28,22,76,43
Sat 15 Aug 2020 12:00,21,9,12,160,66,94,84,50,34,103,63
Sat 15 Aug 2020 13:00,22,15,7,168,67,101,95,65,30,104,70
Sat 15 Aug 2020 14:00,22,14,8,154,49,105,82,48,34,100,89
Sat 15 Aug 2020 15:00,19,8,11,157,73,84,87,45,42,97,83
Sat 15 Aug 2020 16:00,14,5,9,159,72,87,117,76,41,101,102
Sat 15 Aug 2020 17:00,18,9,9,188,83,105,87,56,31,107,82
Sat 15 Aug 2020 18:00,27,17,10,172,96,76,97,52,45,91,78
Sat 15 Aug 2020 19:00,10,3,7,137,66,71,61,37,24,75,61
Sat 15 Aug 2020 20:00,14,9,5,134,67,67,42,24,18,58,62
Sat 15 Aug 2020 21:00,4,3,1,93,61,32,35,18,17,44,21
Sat 15 Aug 2020 22:00,0,0,0,58,31,27,29,12,17,46,24
Sat 15 Aug 2020 23:00,4,2,2,68,45,23,22,8,14,51,13
Sun 16 Aug 2020 00:00,0,0,0,43,27,16,18,7,11,27,10
Sun 16 Aug 2020 01:00,2,2,0,23,22,1,9,4,5,22,7
Sun 16 Aug 2020 02:00,2,1,1,12,4,8,2,2,0,4,3
Sun 16 Aug 2020 03:00,0,0,0,8,2,6,1,1,0,3,1
Sun 16 Aug 2020 04:00,0,0,0,5,2,3,1,1,0,5,3
Sun 16 Aug 2020 05:00,0,0,0,14,5,9,1,1,0,1,5
Sun 16 Aug 2020 06:00,0,0,0,25,5,20,20,16,4,8,13
Sun 16 Aug 2020 07:00,1,1,0,29,12,17,28,24,4,10,23
Sun 16 Aug 2020 08:00,2,1,1,50,7,43,21,19,2,18,31
Sun 16 Aug 2020 09:00,7,6,1,60,21,39,41,26,15,21,36
Sun 16 Aug 2020 10:00,13,7,6,71,20,51,42,27,15,31,31
Sun 16 Aug 2020 11:00,8,8,0,85,28,57,55,43,12,43,45
Sun 16 Aug 2020 12:00,12,5,7,100,30,70,67,39,28,63,41
Sun 16 Aug 2020 13:00,13,7,6,98,35,63,81,50,31,42,50
Sun 16 Aug 2020 14:00,16,9,7,105,47,58,79,45,34,54,62
Sun 16 Aug 2020 15:00,3,2,1,99,46,53,44,22,22,59,32
Sun 16 Aug 2020 16:00,5,2,3,93,42,51,55,32,23,63,57
Sun 16 Aug 2020 17:00,11,10,1,110,56,54,68,37,31,56,40
Sun 16 Aug 2020 18:00,10,7,3,111,48,63,55,35,20,71,52
Sun 16 Aug 2020 19:00,15,10,5,119,69,50,44,29,15,58,44
Sun 16 Aug 2020 20:00,5,3,2,80,39,41,32,17,15,38,30
Sun 16 Aug 2020 21:00,9,5,4,72,43,29,40,22,18,44,23
Sun 16 Aug 2020 22:00,4,4,0,54,39,15,26,11,15,30,13
Sun 16 Aug 2020 23:00,2,2,0,25,16,9,15,5,10,27,8
Mon 17 Aug 2020 00:00,0,0,0,12,6,6,4,2,2,11,4
Mon 17 Aug 2020 01:00,0,0,0,4,2,2,2,0,2,7,1
Mon 17 Aug 2020 02:00,0,0,0,0,0,0,0,0,0,1,2
Mon 17 Aug 2020 03:00,0,0,0,1,1,0,0,0,0,0,0
Mon 17 Aug 2020 04:00,1,1,0,6,3,3,2,2,0,1,4
Mon 17 Aug 2020 05:00,2,2,0,23,2,21,8,8,0,3,10
Mon 17 Aug 2020 06:00,6,4,2,71,11,60,71,67,4,12,55
Mon 17 Aug 2020 07:00,12,9,3,135,24,111,104,84,20,19,84
Mon 17 Aug 2020 08:00,7,7,0,200,46,154,107,98,9,35,110
Mon 17 Aug 2020 09:00,6,5,1,128,30,98,56,48,8,23,67
Mon 17 Aug 2020 10:00,3,1,2,60,13,47,25,21,4,18,42
Mon 17 Aug 2020 11:00,2,2,0,72,31,41,37,30,7,22,29
Mon 17 Aug 2020 12:00,3,1,2,80,31,49,38,29,9,43,41
Mon 17 Aug 2020 13:00,5,4,1,106,44,62,48,33,15,49,43
Mon 17 Aug 2020 14:00,5,3,2,85,52,33,38,23,15,49,36
Mon 17 Aug 2020 15:00,12,7,5,66,41,25,46,24,22,55,31
Mon 17 Aug 2020 16:00,11,3,8,112,69,43,57,25,32,81,35
Mon 17 Aug 2020 17:00,16,3,13,177,101,76,84,35,49,126,58
Mon 17 Aug 2020 18:00,11,3,8,155,95,60,64,30,34,132,34
Mon 17 Aug 2020 19:00,5,4,1,102,51,51,43,23,20,78,40
Mon 17 Aug 2020 20:00,5,1,4,71,37,34,31,13,18,51,26
Mon 17 Aug 2020 21:00,10,6,4,54,30,24,20,5,15,36,18
Mon 17 Aug 2020 22:00,4,4,0,32,23,9,12,5,7,29,12
Mon 17 Aug 2020 23:00,1,1,0,19,14,5,10,4,6,23,7
Tue 18 Aug 2020 00:00,1,1,0,9,6,3,2,2,0,13,7
Tue 18 Aug 2020 01:00,0,0,0,5,3,2,1,1,0,2,4
Tue 18 Aug 2020 02:00,0,0,0,2,0,2,0,0,0,2,3
Tue 18 Aug 2020 03:00,0,0,0,4,2,2,0,0,0,1,1
Tue 18 Aug 2020 04:00,0,0,0,7,3,4,3,3,0,1,4
Tue 18 Aug 2020 05:00,2,2,0,23,4,19,10,8,2,5,13
Tue 18 Aug 2020 06:00,8,8,0,69,9,60,62,55,7,22,49
Tue 18 Aug 2020 07:00,10,6,4,120,30,90,78,64,14,11,81
Tue 18 Aug 2020 08:00,8,8,0,189,46,143,80,69,11,20,106
Tue 18 Aug 2020 09:00,5,3,2,103,20,83,49,45,4,12,44
Tue 18 Aug 2020 10:00,1,1,0,62,18,44,14,12,2,15,38
Tue 18 Aug 2020 11:00,7,5,2,90,24,66,44,36,8,14,36
Tue 18 Aug 2020 12:00,14,9,5,118,42,76,43,26,17,45,38
Tue 18 Aug 2020 13:00,11,8,3,124,51,73,58,40,18,47,39
Tue 18 Aug 2020 14:00,13,9,4,131,46,85,66,38,28,67,53
Tue 18 Aug 2020 15:00,8,4,4,103,41,62,70,39,31,75,57
Tue 18 Aug 2020 16:00,10,4,6,154,86,68,80,42,38,109,74
Tue 18 Aug 2020 17:00,12,5,7,236,122,114,113,57,56,159,50
Tue 18 Aug 2020 18:00,17,8,9,232,122,110,98,49,49,111,48
Tue 18 Aug 2020 19:00,18,12,6,180,80,100,79,44,35,110,49
Tue 18 Aug 2020 20:00,25,16,9,125,55,70,55,31,24,70,52
Tue 18 Aug 2020 21:00,11,6,5,100,66,34,37,16,21,45,46
Tue 18 Aug 2020 22:00,6,4,2,57,39,18,14,12,2,32,19
Tue 18 Aug 2020 23:00,3,1,2,32,22,10,6,3,3,30,5
Wed 19 Aug 2020 00:00,1,0,1,17,11,6,4,4,0,9,9
Wed 19 Aug 2020 01:00,0,0,0,8,4,4,2,2,0,2,1
Wed 19 Aug 2020 02:00,0,0,0,3,1,2,1,1,0,5,3
Wed 19 Aug 2020 03:00,0,0,0,5,2,3,0,0,0,0,1
Wed 19 Aug 2020 04:00,2,1,1,7,1,6,3,2,1,1,4
Wed 19 Aug 2020 05:00,2,2,0,21,2,19,12,11,1,6,16
Wed 19 Aug 2020 06:00,8,7,1,102,19,83,73,66,7,16,66
Wed 19 Aug 2020 07:00,15,11,4,162,40,122,105,94,11,24,109
Wed 19 Aug 2020 08:00,18,16,2,244,60,184,130,118,12,33,159
Wed 19 Aug 2020 09:00,15,9,6,146,41,105,70,58,12,28,80
Wed 19 Aug 2020 10:00,5,3,2,79,23,56,35,23,12,18,56
Wed 19 Aug 2020 11:00,8,4,4,76,26,50,38,27,11,26,35
Wed 19 Aug 2020 12:00,3,2,1,103,30,73,39,23,16,44,34
Wed 19 Aug 2020 13:00,5,3,2,81,40,41,34,21,13,45,27
Wed 19 Aug 2020 14:00,5,3,2,86,45,41,36,19,17,41,32
Wed 19 Aug 2020 15:00,2,1,1,85,49,36,29,10,19,41,28
Wed 19 Aug 2020 16:00,7,3,4,105,65,40,48,22,26,90,22
Wed 19 Aug 2020 17:00,11,5,6,195,119,76,78,28,50,143,39
Wed 19 Aug 2020 18:00,10,2,8,175,107,68,72,36,36,137,32
Wed 19 Aug 2020 19:00,6,2,4,126,60,66,58,32,26,69,31
Wed 19 Aug 2020 20:00,7,1,6,95,49,46,33,17,16,62,18
Wed 19 Aug 2020 21:00,8,7,1,68,43,25,32,19,13,32,30
Wed 19 Aug 2020 22:00,6,1,5,44,33,11,12,3,9,26,11
Wed 19 Aug 2020 23:00,1,0,1,26,17,9,9,5,4,14,2
Thu 20 Aug 2020 00:00,0,0,0,9,5,4,2,1,1,8,2
Thu 20 Aug 2020 01:00,0,0,0,3,3,0,0,0,0,1,1
Thu 20 Aug 2020 02:00,0,0,0,2,0,2,0,0,0,2,1
Thu 20 Aug 2020 03:00,0,0,0,1,0,1,1,1,0,0,0
Thu 20 Aug 2020 04:00,0,0,0,8,2,6,1,1,0,1,6
Thu 20 Aug 2020 05:00,1,1,0,19,2,17,7,5,2,4,10
Thu 20 Aug 2020 06:00,9,8,1,89,16,73,67,62,5,11,57
Thu 20 Aug 2020 07:00,8,6,2,123,30,93,86,75,11,25,100
Thu 20 Aug 2020 08:00,14,11,3,240,68,172,107,96,11,29,146
Thu 20 Aug 2020 09:00,11,9,2,117,36,81,62,50,12,18,74
Thu 20 Aug 2020 10:00,6,3,3,86,23,63,23,18,5,26,40
Thu 20 Aug 2020 11:00,5,4,1,91,26,65,36,26,10,28,32
Thu 20 Aug 2020 12:00,6,3,3,99,39,60,53,36,17,38,31
Thu 20 Aug 2020 13:00,8,6,2,96,41,55,41,28,13,38,42
Thu 20 Aug 2020 14:00,10,4,6,95,44,51,45,22,23,47,42
Thu 20 Aug 2020 15:00,15,10,5,113,54,59,65,32,33,69,43
Thu 20 Aug 2020 16:00,9,4,5,166,87,79,78,44,34,90,46
Thu 20 Aug 2020 17:00,19,8,11,225,130,95,101,49,52,145,56
Thu 20 Aug 2020 18:00,9,2,7,208,109,99,73,33,40,129,46
Thu 20 Aug 2020 19:00,11,6,5,142,80,62,59,41,18,85,54
Thu 20 Aug 2020 20:00,4,1,3,113,63,50,38,25,13,62,35
Thu 20 Aug 2020 21:00,10,6,4,70,44,26,29,12,17,44,27
Thu 20 Aug 2020 22:00,2,1,1,50,31,19,29,7,22,26,9
Thu 20 Aug 2020 23:00,0,0,0,28,19,9,14,2,12,29,7
Fri 21 Aug 2020 00:00,0,0,0,17,11,6,6,3,3,6,3
Fri 21 Aug 2020 01:00,2,2,0,7,6,1,0,0,0,5,0
Fri 21 Aug 2020 02:00,0,0,0,2,1,1,3,1,2,2,1
Fri 21 Aug 2020 03:00,0,0,0,6,2,4,0,0,0,3,0
Fri 21 Aug 2020 04:00,0,0,0,7,2,5,4,4,0,2,5
Fri 21 Aug 2020 05:00,2,1,1,17,5,12,8,6,2,6,10
Fri 21 Aug 2020 06:00,7,5,2,95,17,78,69,65,4,16,48
Fri 21 Aug 2020 07:00,6,6,0,127,33,94,97,84,13,19,85
Fri 21 Aug 2020 08:00,14,12,2,207,50,157,104,91,13,35,127
Fri 21 Aug 2020 09:00,18,15,3,120,31,89,63,55,8,29,81
Fri 21 Aug 2020 10:00,9,4,5,86,13,73,28,18,10,31,54
Fri 21 Aug 2020 11:00,12,8,4,97,34,63,48,35,13,24,21
Fri 21 Aug 2020 12:00,10,4,6,117,38,79,54,34,20,51,38
Fri 21 Aug 2020 13:00,10,5,5,120,57,63,72,41,31,44,43
Fri 21 Aug 2020 14:00,19,8,11,117,51,66,57,38,19,47,47
Fri 21 Aug 2020 15:00,9,9,0,107,58,49,60,35,25,65,37
Fri 21 Aug 2020 16:00,16,5,11,177,84,93,68,27,41,75,49
Fri 21 Aug 2020 17:00,16,6,10,208,111,97,96,54,42,133,55
Fri 21 Aug 2020 18:00,13,6,7,191,101,90,85,47,38,130,62
Fri 21 Aug 2020 19:00,15,8,7,184,80,104,78,44,34,95,57
Fri 21 Aug 2020 20:00,17,8,9,149,74,75,58,32,26,78,49
Fri 21 Aug 2020 21:00,6,3,3,102,55,47,42,24,18,59,33
Fri 21 Aug 2020 22:00,3,2,1,51,24,27,32,13,19,49,21
Fri 21 Aug 2020 23:00,2,1,1,59,40,19,39,20,19,49,16
Sat 22 Aug 2020 00:00,0,0,0,33,19,14,11,7,4,23,11
Sat 22 Aug 2020 01:00,0,0,0,16,7,9,1,0,1,9,4
Sat 22 Aug 2020 02:00,0,0,0,11,9,2,1,0,1,5,2
Sat 22 Aug 2020 03:00,1,1,0,7,5,2,0,0,0,2,3
Sat 22 Aug 2020 04:00,0,0,0,10,4,6,1,1,0,3,3
Sat 22 Aug 2020 05:00,0,0,0,7,4,3,0,0,0,1,7
Sat 22 Aug 2020 06:00,1,1,0,45,8,37,16,16,0,13,19
Sat 22 Aug 2020 07:00,6,5,1,51,19,32,40,33,7,17,45
Sat 22 Aug 2020 08:00,5,4,1,74,31,43,30,28,2,22,35
Sat 22 Aug 2020 09:00,15,9,6,80,32,48,39,32,7,29,36
Sat 22 Aug 2020 10:00,15,4,11,108,39,69,57,37,20,21,62
Sat 22 Aug 2020 11:00,15,13,2,113,37,76,74,55,19,48,39
Sat 22 Aug 2020 12:00,15,9,6,128,52,76,64,39,25,56,37
Sat 22 Aug 2020 13:00,9,4,5,131,51,80,77,41,36,45,61
Sat 22 Aug 2020 14:00,12,8,4,90,35,55,55,33,22,72,57
Sat 22 Aug 2020 15:00,7,5,2,106,45,61,53,29,24,63,63
Sat 22 Aug 2020 16:00,6,2,4,96,44,52,59,30,29,74,62
Sat 22 Aug 2020 17:00,10,7,3,110,55,55,52,34,18,90,43
Sat 22 Aug 2020 18:00,6,2,4,96,49,47,57,41,16,67,49
Sat 22 Aug 2020 19:00,10,7,3,113,55,58,42,29,13,52,34
Sat 22 Aug 2020 20:00,10,5,5,97,37,60,42,28,14,41,32
Sat 22 Aug 2020 21:00,5,1,4,72,46,26,24,15,9,46,26
Sat 22 Aug 2020 22:00,6,3,3,65,46,19,25,14,11,35,22
Sat 22 Aug 2020 23:00,0,0,0,41,28,13,17,6,11,41,13
Sun 23 Aug 2020 00:00,4,3,1,29,20,9,8,6,2,25,4
Sun 23 Aug 2020 01:00,0,0,0,18,13,5,5,0,5,14,7
Sun 23 Aug 2020 02:00,1,1,0,14,11,3,3,0,3,7,2
Sun 23 Aug 2020 03:00,3,3,0,10,7,3,2,0,2,4,0
Sun 23 Aug 2020 04:00,1,1,0,3,2,1,2,2,0,6,2
Sun 23 Aug 2020 05:00,1,1,0,8,3,5,5,3,2,1,8
Sun 23 Aug 2020 06:00,2,2,0,17,4,13,18,15,3,8,12
Sun 23 Aug 2020 07:00,0,0,0,34,12,22,22,18,4,15,26
Sun 23 Aug 2020 08:00,2,2,0,48,17,31,46,35,11,24,38
Sun 23 Aug 2020 09:00,13,8,5,62,24,38,44,27,17,36,31
Sun 23 Aug 2020 10:00,6,5,1,79,21,58,39,30,9,33,48
Sun 23 Aug 2020 11:00,6,2,4,103,29,74,68,43,25,55,37
Sun 23 Aug 2020 12:00,17,8,9,100,41,59,70,42,28,64,71
Sun 23 Aug 2020 13:00,9,5,4,134,57,77,66,39,27,64,62
Sun 23 Aug 2020 14:00,14,6,8,120,54,66,91,52,39,78,62
Sun 23 Aug 2020 15:00,8,7,1,125,58,67,82,48,34,58,59
Sun 23 Aug 2020 16:00,7,3,4,100,48,52,71,50,21,62,68
Sun 23 Aug 2020 17:00,19,11,8,117,49,68,65,32,33,82,58
Sun 23 Aug 2020 18:00,11,6,5,149,89,60,53,28,25,76,64
Sun 23 Aug 2020 19:00,11,2,9,118,74,44,49,27,22,70,43
Sun 23 Aug 2020 20:00,10,2,8,82,49,33,39,21,18,34,27
Sun 23 Aug 2020 21:00,5,3,2,68,41,27,22,12,10,41,29
Sun 23 Aug 2020 22:00,1,1,0,42,21,21,34,17,17,34,9
Sun 23 Aug 2020 23:00,4,1,3,25,16,9,18,10,8,20,9
Mon 24 Aug 2020 00:00,2,0,2,12,7,5,3,1,2,11,2
Mon 24 Aug 2020 01:00,0,0,0,17,11,6,1,0,1,5,1
Mon 24 Aug 2020 02:00,1,0,1,7,5,2,0,0,0,1,3
Mon 24 Aug 2020 03:00,0,0,0,3,2,1,2,1,1,1,0
Mon 24 Aug 2020 04:00,0,0,0,8,5,3,1,1,0,1,5
Mon 24 Aug 2020 05:00,1,1,0,20,1,19,11,9,2,7,20
Mon 24 Aug 2020 06:00,7,7,0,99,22,77,71,66,5,14,73
Mon 24 Aug 2020 07:00,12,10,2,171,57,114,102,89,13,20,101
Mon 24 Aug 2020 08:00,13,10,3,266,70,196,122,110,12,42,184
Mon 24 Aug 2020 09:00,11,10,1,111,29,82,63,53,10,40,95
Mon 24 Aug 2020 10:00,5,4,1,82,27,55,42,36,6,27,50
Mon 24 Aug 2020 11:00,4,0,4,107,28,79,47,40,7,33,53
Mon 24 Aug 2020 12:00,6,3,3,130,49,81,76,53,23,54,72
Mon 24 Aug 2020 13:00,10,4,6,124,58,66,80,39,41,74,61
Mon 24 Aug 2020 14:00,10,3,7,128,62,66,66,31,35,75,43
Mon 24 Aug 2020 15:00,14,5,9,114,53,61,76,40,36,86,65
Mon 24 Aug 2020 16:00,9,4,5,170,98,72,92,54,38,154,58
Mon 24 Aug 2020 17:00,25,13,12,319,181,138,156,69,87,161,51
Mon 24 Aug 2020 18:00,18,7,11,223,117,106,108,52,56,194,55
Mon 24 Aug 2020 19:00,18,11,7,160,83,77,57,29,28,106,41
Mon 24 Aug 2020 20:00,10,4,6,150,86,64,53,22,31,67,21
Mon 24 Aug 2020 21:00,6,3,3,64,42,22,29,14,15,41,29
Mon 24 Aug 2020 22:00,6,4,2,48,34,14,18,10,8,29,14
Mon 24 Aug 2020 23:00,1,0,1,27,17,10,8,2,6,20,6
Tue 25 Aug 2020 00:00,0,0,0,8,7,1,4,3,1,7,5
Tue 25 Aug 2020 01:00,0,0,0,4,2,2,2,1,1,3,1
Tue 25 Aug 2020 02:00,1,0,1,2,2,0,0,0,0,1,0
Tue 25 Aug 2020 03:00,0,0,0,5,0,5,2,2,0,1,0
Tue 25 Aug 2020 04:00,0,0,0,5,1,4,1,1,0,1,2
Tue 25 Aug 2020 05:00,3,3,0,12,1,11,6,4,2,5,10
Tue 25 Aug 2020 06:00,8,7,1,74,18,56,64,57,7,11,32
Tue 25 Aug 2020 07:00,8,7,1,137,30,107,83,74,9,18,85
Tue 25 Aug 2020 08:00,14,11,3,224,50,174,112,101,11,27,151
Tue 25 Aug 2020 09:00,12,6,6,119,27,92,49,43,6,15,56
Tue 25 Aug 2020 10:00,6,6,0,62,16,46,19,15,4,16,38
Tue 25 Aug 2020 11:00,2,2,0,76,26,50,34,30,4,10,25
Tue 25 Aug 2020 12:00,6,4,2,89,35,54,39,30,9,36,35
Tue 25 Aug 2020 13:00,6,3,3,98,39,59,44,32,12,32,23
Tue 25 Aug 2020 14:00,7,4,3,78,38,40,41,20,21,42,12
Tue 25 Aug 2020 15:00,4,3,1,61,28,33,30,15,15,30,13
Tue 25 Aug 2020 16:00,9,2,7,98,54,44,59,31,28,77,17
Tue 25 Aug 2020 17:00,16,7,9,180,111,69,62,26,36,126,39
Tue 25 Aug 2020 18:00,10,4,6,148,84,64,71,30,41,100,17
Tue 25 Aug 2020 19:00,10,5,5,122,56,66,38,24,14,56,26
Tue 25 Aug 2020 20:00,10,3,7,67,32,35,31,18,13,31,33
Tue 25 Aug 2020 21:00,5,1,4,49,26,23,8,6,2,24,12
Tue 25 Aug 2020 22:00,3,1,2,42,31,11,17,12,5,19,5
Tue 25 Aug 2020 23:00,0,0,0,21,14,7,3,2,1,21,8
Wed 26 Aug 2020 00:00,1,1,0,9,7,2,3,3,0,4,5
Wed 26 Aug 2020 01:00,0,0,0,5,3,2,1,1,0,0,1
Wed 26 Aug 2020 02:00,0,0,0,3,0,3,0,0,0,1,1
Wed 26 Aug 2020 03:00,0,0,0,3,3,0,0,0,0,0,0
Wed 26 Aug 2020 04:00,0,0,0,10,5,5,0,0,0,1,5
Wed 26 Aug 2020 05:00,3,2,1,22,2,20,14,13,1,4,16
Wed 26 Aug 2020 06:00,6,5,1,96,18,78,72,63,9,24,54
Wed 26 Aug 2020 07:00,14,11,3,186,51,135,119,104,15,31,138
Wed 26 Aug 2020 08:00,12,10,2,259,58,201,122,106,16,30,189
Wed 26 Aug 2020 09:00,19,13,6,127,38,89,71,63,8,29,87
Wed 26 Aug 2020 10:00,5,2,3,97,27,70,38,29,9,25,53
Wed 26 Aug 2020 11:00,8,3,5,102,27,75,47,34,13,32,58
Wed 26 Aug 2020 12:00,15,7,8,147,56,91,61,40,21,53,60
Wed 26 Aug 2020 13:00,12,9,3,144,51,93,57,37,20,70,47
Wed 26 Aug 2020 14:00,8,4,4,145,59,86,51,24,27,90,51
Wed 26 Aug 2020 15:00,13,10,3,116,55,61,71,39,32,91,58
Wed 26 Aug 2020 16:00,11,5,6,219,111,108,119,52,67,141,68
Wed 26 Aug 2020 17:00,30,15,15,312,164,148,145,64,81,213,65
Wed 26 Aug 2020 18:00,26,9,17,314,168,146,143,81,62,185,77
Wed 26 Aug 2020 19:00,10,2,8,251,131,120,98,48,50,119,66
Wed 26 Aug 2020 20:00,8,4,4,168,91,77,83,41,42,83,66
Wed 26 Aug 2020 21:00,6,3,3,97,53,44,35,17,18,48,45
Wed 26 Aug 2020 22:00,7,2,5,61,45,16,17,9,8,34,21
Wed 26 Aug 2020 23:00,3,1,2,48,33,15,9,3,6,27,13
Thu 27 Aug 2020 00:00,0,0,0,22,16,6,4,4,0,16,8
Thu 27 Aug 2020 01:00,0,0,0,9,8,1,6,4,2,8,1
Thu 27 Aug 2020 02:00,0,0,0,7,6,1,0,0,0,6,0
Thu 27 Aug 2020 03:00,0,0,0,5,2,3,1,1,0,1,0
Thu 27 Aug 2020 04:00,0,0,0,11,2,9,1,1,0,1,5
Thu 27 Aug 2020 05:00,1,1,0,17,3,14,15,13,2,3,8
Thu 27 Aug 2020 06:00,8,7,1,99,26,73,89,76,13,18,67
Thu 27 Aug 2020 07:00,22,18,4,160,44,116,102,89,13,20,104
Thu 27 Aug 2020 08:00,9,8,1,246,58,188,117,105,12,36,175
Thu 27 Aug 2020 09:00,11,10,1,149,36,113,67,61,6,27,87
Thu 27 Aug 2020 10:00,8,5,3,82,30,52,31,25,6,18,46
Thu 27 Aug 2020 11:00,7,1,6,84,18,66,34,24,10,29,32
Thu 27 Aug 2020 12:00,8,5,3,114,45,69,44,27,17,36,36
Thu 27 Aug 2020 13:00,4,1,3,109,44,65,39,22,17,43,49
Thu 27 Aug 2020 14:00,7,3,4,98,43,55,45,25,20,47,37
Thu 27 Aug 2020 15:00,13,5,8,113,62,51,54,22,32,65,24
Thu 27 Aug 2020 16:00,14,5,9,123,65,58,65,34,31,92,45
Thu 27 Aug 2020 17:00,19,10,9,214,130,84,94,46,48,147,36
Thu 27 Aug 2020 18:00,15,8,7,210,117,93,76,38,38,122,28
Thu 27 Aug 2020 19:00,9,2,7,152,78,74,64,30,34,85,31
Thu 27 Aug 2020 20:00,8,2,6,120,66,54,50,31,19,65,46
Thu 27 Aug 2020 21:00,5,1,4,80,57,23,28,17,11,47,15
Thu 27 Aug 2020 22:00,6,4,2,42,28,14,20,9,11,18,10
Thu 27 Aug 2020 23:00,3,2,1,31,24,7,10,3,7,23,6
Fri 28 Aug 2020 00:00,2,0,2,13,7,6,1,1,0,8,3
Fri 28 Aug 2020 01:00,0,0,0,5,5,0,4,2,2,6,1
Fri 28 Aug 2020 02:00,1,0,1,4,2,2,0,0,0,3,2
Fri 28 Aug 2020 03:00,0,0,0,7,4,3,2,2,0,1,0
Fri 28 Aug 2020 04:00,0,0,0,8,2,6,1,1,0,1,2
Fri 28 Aug 2020 05:00,2,1,1,21,5,16,8,8,0,2,16
Fri 28 Aug 2020 06:00,7,7,0,92,13,79,69,61,8,16,42
Fri 28 Aug 2020 07:00,9,9,0,126,33,93,87,76,11,16,80
Fri 28 Aug 2020 08:00,13,10,3,184,53,131,82,72,10,24,100
Fri 28 Aug 2020 09:00,6,4,2,88,13,75,44,40,4,14,33
Fri 28 Aug 2020 10:00,1,0,1,59,17,42,17,11,6,5,16
Fri 28 Aug 2020 11:00,6,4,2,51,11,40,23,18,5,15,21
Fri 28 Aug 2020 12:00,6,3,3,116,45,71,48,33,15,35,49
Fri 28 Aug 2020 13:00,6,4,2,117,39,78,47,24,23,58,40
Fri 28 Aug 2020 14:00,8,2,6,129,53,76,55,29,26,58,37
Fri 28 Aug 2020 15:00,15,6,9,119,51,68,48,28,20,68,36
Fri 28 Aug 2020 16:00,10,3,7,159,87,72,70,35,35,102,59
Fri 28 Aug 2020 17:00,12,6,6,231,134,97,92,48,44,147,62
Fri 28 Aug 2020 18:00,11,4,7,168,86,82,79,38,41,112,55
Fri 28 Aug 2020 19:00,12,6,6,170,78,92,69,37,32,82,58
Fri 28 Aug 2020 20:00,15,7,8,140,73,67,33,18,15,52,28
Fri 28 Aug 2020 21:00,9,4,5,103,64,39,39,16,23,42,37
Fri 28 Aug 2020 22:00,5,2,3,48,25,23,34,18,16,40,21
Fri 28 Aug 2020 23:00,3,2,1,57,41,16,28,8,20,48,21
Sat 29 Aug 2020 00:00,0,0,0,31,25,6,6,4,2,18,6
Sat 29 Aug 2020 01:00,3,3,0,23,13,10,3,2,1,9,9
Sat 29 Aug 2020 02:00,0,0,0,7,3,4,3,2,1,4,2
Sat 29 Aug 2020 03:00,0,0,0,5,4,1,3,2,1,0,2
Sat 29 Aug 2020 04:00,0,0,0,7,5,2,3,3,0,0,1
Sat 29 Aug 2020 05:00,1,1,0,8,2,6,3,3,0,3,5
Sat 29 Aug 2020 06:00,2,1,1,32,2,30,19,17,2,12,19
Sat 29 Aug 2020 07:00,2,1,1,52,12,40,44,37,7,7,35
Sat 29 Aug 2020 08:00,7,5,2,74,26,48,34,28,6,14,39
Sat 29 Aug 2020 09:00,7,5,2,91,41,50,44,36,8,32,53
Sat 29 Aug 2020 10:00,22,10,12,118,45,73,68,33,35,50,46
Sat 29 Aug 2020 11:00,22,15,7,107,40,67,47,32,15,61,54
Sat 29 Aug 2020 12:00,17,6,11,126,45,81,68,44,24,61,53
Sat 29 Aug 2020 13:00,23,12,11,152,61,91,67,38,29,64,55
Sat 29 Aug 2020 14:00,28,17,11,138,62,76,69,41,28,77,64
Sat 29 Aug 2020 15:00,16,11,5,132,52,80,86,49,37,79,73
Sat 29 Aug 2020 16:00,12,9,3,146,67,79,71,35,36,70,66
Sat 29 Aug 2020 17:00,12,2,10,126,72,54,62,41,21,62,60
Sat 29 Aug 2020 18:00,11,5,6,117,59,58,60,33,27,82,36
Sat 29 Aug 2020 19:00,16,8,8,129,71,58,57,33,24,77,45
Sat 29 Aug 2020 20:00,5,1,4,98,51,47,35,20,15,34,35
Sat 29 Aug 2020 21:00,5,2,3,95,56,39,28,17,11,34,20
Sat 29 Aug 2020 22:00,4,1,3,64,40,24,26,13,13,30,11
Sat 29 Aug 2020 23:00,2,2,0,39,31,8,26,11,15,33,24
Sun 30 Aug 2020 00:00,0,0,0,28,21,7,10,5,5,23,10
Sun 30 Aug 2020 01:00,1,0,1,19,14,5,6,3,3,13,3
Sun 30 Aug 2020 02:00,0,0,0,7,5,2,4,2,2,9,3
Sun 30 Aug 2020 03:00,1,0,1,9,3,6,1,1,0,4,0
Sun 30 Aug 2020 04:00,0,0,0,3,3,0,2,2,0,3,3
Sun 30 Aug 2020 05:00,1,1,0,12,4,8,2,0,2,2,2
Sun 30 Aug 2020 06:00,1,1,0,19,3,16,17,14,3,12,8
Sun 30 Aug 2020 07:00,1,0,1,37,14,23,18,15,3,11,23
Sun 30 Aug 2020 08:00,0,0,0,50,14,36,20,17,3,13,32
Sun 30 Aug 2020 09:00,2,1,1,72,35,37,49,26,23,30,39
Sun 30 Aug 2020 10:00,21,15,6,114,26,88,76,58,18,58,59
Sun 30 Aug 2020 11:00,14,7,7,147,56,91,101,59,42,70,65
Sun 30 Aug 2020 12:00,21,13,8,177,65,112,94,59,35,66,67
Sun 30 Aug 2020 13:00,21,10,11,136,63,73,135,65,70,104,85
Sun 30 Aug 2020 14:00,21,13,8,157,73,84,94,52,42,89,75
Sun 30 Aug 2020 15:00,9,4,5,142,66,76,100,63,37,64,89
Sun 30 Aug 2020 16:00,17,9,8,161,63,98,80,47,33,53,66
Sun 30 Aug 2020 17:00,9,5,4,123,66,57,84,46,38,68,57
Sun 30 Aug 2020 18:00,13,6,7,147,76,71,64,36,28,57,61
Sun 30 Aug 2020 19:00,9,6,3,118,65,53,72,44,28,54,49
Sun 30 Aug 2020 20:00,3,1,2,110,60,50,50,31,19,40,42
Sun 30 Aug 2020 21:00,11,3,8,79,49,30,14,7,7,48,10
Sun 30 Aug 2020 22:00,1,1,0,53,33,20,22,6,16,24,11
Sun 30 Aug 2020 23:00,1,1,0,25,17,8,9,3,6,24,10
Mon 31 Aug 2020 00:00,2,0,2,9,6,3,5,4,1,5,4
Mon 31 Aug 2020 01:00,0,0,0,7,3,4,0,0,0,8,0
Mon 31 Aug 2020 02:00,0,0,0,6,3,3,2,0,2,5,1
Mon 31 Aug 2020 03:00,0,0,0,4,3,1,2,1,1,1,1
Mon 31 Aug 2020 04:00,0,0,0,7,4,3,1,1,0,2,6
Mon 31 Aug 2020 05:00,0,0,0,23,3,20,7,7,0,5,16
Mon 31 Aug 2020 06:00,11,8,3,96,14,82,80,73,7,7,71
Mon 31 Aug 2020 07:00,7,5,2,197,55,142,104,92,12,22,106
Mon 31 Aug 2020 08:00,32,26,6,271,64,207,159,136,23,40,183
Mon 31 Aug 2020 09:00,11,8,3,138,36,102,70,62,8,41,90
Mon 31 Aug 2020 10:00,10,4,6,110,39,71,59,48,11,25,70
Mon 31 Aug 2020 11:00,9,6,3,107,40,67,58,44,14,43,62
Mon 31 Aug 2020 12:00,13,10,3,131,43,88,65,43,22,67,59
Mon 31 Aug 2020 13:00,8,7,1,139,67,72,76,45,31,76,53
Mon 31 Aug 2020 14:00,16,6,10,135,52,83,50,26,24,71,48
Mon 31 Aug 2020 15:00,9,5,4,160,82,78,65,28,37,94,45
Mon 31 Aug 2020 16:00,17,10,7,182,101,81,90,45,45,144,63
Mon 31 Aug 2020 17:00,28,15,13,266,151,115,166,82,84,205,68
Mon 31 Aug 2020 18:00,21,10,11,249,128,121,112,49,63,170,57
Mon 31 Aug 2020 19:00,15,5,10,170,77,93,70,32,38,96,39
Mon 31 Aug 2020 20:00,16,8,8,102,33,69,61,26,35,55,49
Mon 31 Aug 2020 21:00,11,6,5,71,45,26,23,13,10,42,30
Mon 31 Aug 2020 22:00,2,1,1,58,42,16,10,7,3,36,20
Mon 31 Aug 2020 23:00,2,0,2,25,17,8,7,3,4,11,6
Tue 1 Sep 2020 00:00,0,0,0,7,6,1,4,3,1,14,4
Tue 1 Sep 2020 01:00,2,1,1,4,4,0,2,2,0,4,1
Tue 1 Sep 2020 02:00,1,1,0,2,1,1,3,1,2,3,1
Tue 1 Sep 2020 03:00,0,0,0,4,2,2,2,2,0,1,0
Tue 1 Sep 2020 04:00,0,0,0,10,2,8,0,0,0,1,6
Tue 1 Sep 2020 05:00,2,2,0,25,3,22,6,6,0,6,17
Tue 1 Sep 2020 06:00,9,7,2,109,18,91,89,79,10,13,69
Tue 1 Sep 2020 07:00,15,12,3,218,62,156,122,107,15,32,127
Tue 1 Sep 2020 08:00,27,19,8,301,81,220,180,162,18,50,221
Tue 1 Sep 2020 09:00,15,11,4,159,35,124,86,77,9,38,102
Tue 1 Sep 2020 10:00,7,5,2,74,24,50,48,33,15,30,61
Tue 1 Sep 2020 11:00,11,6,5,101,35,66,38,30,8,33,44
Tue 1 Sep 2020 12:00,12,9,3,135,49,86,72,51,21,78,55
Tue 1 Sep 2020 13:00,14,8,6,136,59,77,71,42,29,72,49
Tue 1 Sep 2020 14:00,18,7,11,130,63,67,72,43,29,70,58
Tue 1 Sep 2020 15:00,14,6,8,147,53,94,58,26,32,91,55
Tue 1 Sep 2020 16:00,17,12,5,215,124,91,97,47,50,154,67
Tue 1 Sep 2020 17:00,27,13,14,339,207,132,144,65,79,225,82
Tue 1 Sep 2020 18:00,23,12,11,295,171,124,132,58,74,189,76
Tue 1 Sep 2020 19:00,12,3,9,186,93,93,89,48,41,116,64
Tue 1 Sep 2020 20:00,18,5,13,148,68,80,70,32,38,72,39
Tue 1 Sep 2020 21:00,6,3,3,75,48,27,27,20,7,61,22
Tue 1 Sep 2020 22:00,7,2,5,58,45,13,19,15,4,34,13
Tue 1 Sep 2020 23:00,1,1,0,45,32,13,11,6,5,21,8
Wed 2 Sep 2020 00:00,0,0,0,11,7,4,3,3,0,18,8
Wed 2 Sep 2020 01:00,0,0,0,11,7,4,1,1,0,7,2
Wed 2 Sep 2020 02:00,0,0,0,6,4,2,0,0,0,2,2
Wed 2 Sep 2020 03:00,0,0,0,4,2,2,0,0,0,2,0
Wed 2 Sep 2020 04:00,0,0,0,13,2,11,1,1,0,3,4
Wed 2 Sep 2020 05:00,1,1,0,23,3,20,10,8,2,5,12
Wed 2 Sep 2020 06:00,8,8,0,78,14,64,73,63,10,12,59
Wed 2 Sep 2020 07:00,10,8,2,174,46,128,81,74,7,18,84
Wed 2 Sep 2020 08:00,10,8,2,200,53,147,85,79,6,19,102
Wed 2 Sep 2020 09:00,4,4,0,87,17,70,35,33,2,13,54
Wed 2 Sep 2020 10:00,2,1,1,51,18,33,6,4,2,14,17
Wed 2 Sep 2020 11:00,2,2,0,68,19,49,36,29,7,21,30
Wed 2 Sep 2020 12:00,6,3,3,111,43,68,49,37,12,25,41
Wed 2 Sep 2020 13:00,10,7,3,124,58,66,51,33,18,54,40
Wed 2 Sep 2020 14:00,11,6,5,124,59,65,55,37,18,50,48
Wed 2 Sep 2020 15:00,7,4,3,122,55,67,62,29,33,76,42
Wed 2 Sep 2020 16:00,7,4,3,156,80,76,83,41,42,94,45
Wed 2 Sep 2020 17:00,12,6,6,244,144,100,113,45,68,125,46
Wed 2 Sep 2020 18:00,25,7,18,223,126,97,144,76,68,126,38
Wed 2 Sep 2020 19:00,19,9,10,174,77,97,197,110,87,85,38
Wed 2 Sep 2020 20:00,9,5,4,131,80,51,55,29,26,66,25
Wed 2 Sep 2020 21:00,11,8,3,83,49,34,40,16,24,44,22
Wed 2 Sep 2020 22:00,2,0,2,52,39,13,12,7,5,41,12
Wed 2 Sep 2020 23:00,6,3,3,35,26,9,6,2,4,18,10
Thu 3 Sep 2020 00:00,1,1,0,20,11,9,3,3,0,10,5
Thu 3 Sep 2020 01:00,0,0,0,3,3,0,1,1,0,3,0
Thu 3 Sep 2020 02:00,0,0,0,2,1,1,1,1,0,2,1
Thu 3 Sep 2020 03:00,0,0,0,3,2,1,0,0,0,1,3
Thu 3 Sep 2020 04:00,0,0,0,12,2,10,0,0,0,1,5
Thu 3 Sep 2020 05:00,1,1,0,22,1,21,7,5,2,5,15
Thu 3 Sep 2020 06:00,6,6,0,89,15,74,76,69,7,9,69
Thu 3 Sep 2020 07:00,19,17,2,225,54,171,127,115,12,24,147
Thu 3 Sep 2020 08:00,31,26,5,311,83,228,177,161,16,50,192
Thu 3 Sep 2020 09:00,7,4,3,165,41,124,101,92,9,21,125
Thu 3 Sep 2020 10:00,10,5,5,87,29,58,47,34,13,27,49
Thu 3 Sep 2020 11:00,6,3,3,106,36,70,56,45,11,35,45
Thu 3 Sep 2020 12:00,13,6,7,160,49,111,63,44,19,59,72
Thu 3 Sep 2020 13:00,17,7,10,142,57,85,84,50,34,84,65
Thu 3 Sep 2020 14:00,19,7,12,135,58,77,73,46,27,74,47
Thu 3 Sep 2020 15:00,16,6,10,155,70,85,66,33,33,92,61
Thu 3 Sep 2020 16:00,11,6,5,197,103,94,91,41,50,148,62
Thu 3 Sep 2020 17:00,21,7,14,339,183,156,138,54,84,177,67
Thu 3 Sep 2020 18:00,21,11,10,256,143,113,130,55,75,200,56
Thu 3 Sep 2020 19:00,16,7,9,196,92,104,73,42,31,121,50
Thu 3 Sep 2020 20:00,15,8,7,157,80,77,70,31,39,59,43
Thu 3 Sep 2020 21:00,3,3,0,105,68,37,31,19,12,37,17
Thu 3 Sep 2020 22:00,2,2,0,63,45,18,19,10,9,38,17
Thu 3 Sep 2020 23:00,0,0,0,47,34,13,11,4,7,37,14
Fri 4 Sep 2020 00:00,0,0,0,24,19,5,4,1,3,26,2
Fri 4 Sep 2020 01:00,0,0,0,9,7,2,3,3,0,4,3
Fri 4 Sep 2020 02:00,0,0,0,4,2,2,0,0,0,4,0
Fri 4 Sep 2020 03:00,0,0,0,6,3,3,4,2,2,2,1
Fri 4 Sep 2020 04:00,1,0,1,14,5,9,1,1,0,2,6
Fri 4 Sep 2020 05:00,2,2,0,28,2,26,8,7,1,5,13
Fri 4 Sep 2020 06:00,9,8,1,87,19,68,76,72,4,12,79
Fri 4 Sep 2020 07:00,14,14,0,208,56,152,112,105,7,29,118
Fri 4 Sep 2020 08:00,31,25,6,299,70,229,164,144,20,55,195
Fri 4 Sep 2020 09:00,10,6,4,143,40,103,73,57,16,30,88
Fri 4 Sep 2020 10:00,7,5,2,95,27,68,50,37,13,31,56
Fri 4 Sep 2020 11:00,12,5,7,105,26,79,49,35,14,29,51
Fri 4 Sep 2020 12:00,11,7,4,157,55,102,63,42,21,69,50
Fri 4 Sep 2020 13:00,15,11,4,162,72,90,71,43,28,78,45
Fri 4 Sep 2020 14:00,14,4,10,168,65,103,60,37,23,72,44
Fri 4 Sep 2020 15:00,20,10,10,152,72,80,73,35,38,94,25
Fri 4 Sep 2020 16:00,16,8,8,223,124,99,107,49,58,151,50
Fri 4 Sep 2020 17:00,22,9,13,262,146,116,126,59,67,173,57
Fri 4 Sep 2020 18:00,13,7,6,186,101,85,102,49,53,126,52
Fri 4 Sep 2020 19:00,12,6,6,213,106,107,59,36,23,70,18
Fri 4 Sep 2020 20:00,13,6,7,115,44,71,58,27,31,56,52
Fri 4 Sep 2020 21:00,8,5,3,88,47,41,29,17,12,46,31
Fri 4 Sep 2020 22:00,0,0,0,62,41,21,22,6,16,46,18
Fri 4 Sep 2020 23:00,5,1,4,71,56,15,22,8,14,48,12
Sat 5 Sep 2020 00:00,0,0,0,32,22,10,9,1,8,23,3
Sat 5 Sep 2020 01:00,0,0,0,16,11,5,9,3,6,14,4
Sat 5 Sep 2020 02:00,1,1,0,10,5,5,1,1,0,8,5
Sat 5 Sep 2020 03:00,0,0,0,3,3,0,0,0,0,6,5
Sat 5 Sep 2020 04:00,0,0,0,5,2,3,3,2,1,2,3
Sat 5 Sep 2020 05:00,3,2,1,14,5,9,6,4,2,2,8
Sat 5 Sep 2020 06:00,0,0,0,31,4,27,23,20,3,7,21
Sat 5 Sep 2020 07:00,2,0,2,58,16,42,34,32,2,12,35
Sat 5 Sep 2020 08:00,8,6,2,69,28,41,38,30,8,26,40
Sat 5 Sep 2020 09:00,12,10,2,80,26,54,64,50,14,35,62
Sat 5 Sep 2020 10:00,10,7,3,96,37,59,58,48,10,39,55
Sat 5 Sep 2020 11:00,21,10,11,114,26,88,79,49,30,52,55
Sat 5 Sep 2020 12:00,18,10,8,135,54,81,75,47,28,73,58
Sat 5 Sep 2020 13:00,19,13,6,137,62,75,84,46,38,79,61
Sat 5 Sep 2020 14:00,16,7,9,158,62,96,60,34,26,73,63
Sat 5 Sep 2020 15:00,19,4,15,120,51,69,59,34,25,84,76
Sat 5 Sep 2020 16:00,2,1,1,137,68,69,55,27,28,73,64
Sat 5 Sep 2020 17:00,18,14,4,112,56,56,57,33,24,55,69
Sat 5 Sep 2020 18:00,10,5,5,118,68,50,61,40,21,72,48
Sat 5 Sep 2020 19:00,10,6,4,98,52,46,36,19,17,51,32
Sat 5 Sep 2020 20:00,5,3,2,67,41,26,27,19,8,22,24
Sat 5 Sep 2020 21:00,3,0,3,50,26,24,22,14,8,26,21
Sat 5 Sep 2020 22:00,0,0,0,40,29,11,17,8,9,30,5
Sat 5 Sep 2020 23:00,5,2,3,38,22,16,15,3,12,31,12
Sun 6 Sep 2020 00:00,1,1,0,34,22,12,9,5,4,19,3
Sun 6 Sep 2020 01:00,1,0,1,18,13,5,4,2,2,14,7
Sun 6 Sep 2020 02:00,0,0,0,6,5,1,1,0,1,7,1
Sun 6 Sep 2020 03:00,0,0,0,3,2,1,0,0,0,3,1
Sun 6 Sep 2020 04:00,0,0,0,5,4,1,1,0,1,2,2
Sun 6 Sep 2020 05:00,0,0,0,10,2,8,3,2,1,2,3
Sun 6 Sep 2020 06:00,1,1,0,19,5,14,12,10,2,5,17
Sun 6 Sep 2020 07:00,1,1,0,40,10,30,27,21,6,12,24
Sun 6 Sep 2020 08:00,7,4,3,54,20,34,26,22,4,27,32
Sun 6 Sep 2020 09:00,5,2,3,73,25,48,39,35,4,20,40
Sun 6 Sep 2020 10:00,11,7,4,80,29,51,50,32,18,43,38
Sun 6 Sep 2020 11:00,17,16,1,89,23,66,63,50,13,54,41
Sun 6 Sep 2020 12:00,15,11,4,117,50,67,71,39,32,63,33
Sun 6 Sep 2020 13:00,20,14,6,128,55,73,95,51,44,77,68
Sun 6 Sep 2020 14:00,13,12,1,118,48,70,77,39,38,78,70
Sun 6 Sep 2020 15:00,11,5,6,122,51,71,88,57,31,69,80
Sun 6 Sep 2020 16:00,13,4,9,140,71,69,82,49,33,85,69
Sun 6 Sep 2020 17:00,14,6,8,149,76,73,79,41,38,84,70
Sun 6 Sep 2020 18:00,7,3,4,117,64,53,62,38,24,74,77
Sun 6 Sep 2020 19:00,7,3,4,107,56,51,70,39,31,63,29
Sun 6 Sep 2020 20:00,6,2,4,114,51,63,56,23,33,54,32
Sun 6 Sep 2020 21:00,5,4,1,77,39,38,32,17,15,35,20
Sun 6 Sep 2020 22:00,3,2,1,42,33,9,31,17,14,43,18
Sun 6 Sep 2020 23:00,1,1,0,25,16,9,6,4,2,25,4
Mon 7 Sep 2020 00:00,2,0,2,15,9,6,7,3,4,16,2
Mon 7 Sep 2020 01:00,0,0,0,3,1,2,0,0,0,7,3
Mon 7 Sep 2020 02:00,0,0,0,8,6,2,0,0,0,1,1
Mon 7 Sep 2020 03:00,0,0,0,2,1,1,1,1,0,4,1
Mon 7 Sep 2020 04:00,0,0,0,8,3,5,0,0,0,0,7
Mon 7 Sep 2020 05:00,2,2,0,26,1,25,11,9,2,4,18
Mon 7 Sep 2020 06:00,4,4,0,83,14,69,78,72,6,10,62
Mon 7 Sep 2020 07:00,15,10,5,182,48,134,105,89,16,24,116
Mon 7 Sep 2020 08:00,19,13,6,258,61,197,121,111,10,38,143
Mon 7 Sep 2020 09:00,6,2,4,127,31,96,81,72,9,19,67
Mon 7 Sep 2020 10:00,5,4,1,67,20,47,30,24,6,21,38
Mon 7 Sep 2020 11:00,6,5,1,83,30,53,46,34,12,27,41
Mon 7 Sep 2020 12:00,9,4,5,133,52,81,34,25,9,29,32
Mon 7 Sep 2020 13:00,6,3,3,118,54,64,45,29,16,62,30
Mon 7 Sep 2020 14:00,9,3,6,101,47,54,62,38,24,51,24
Mon 7 Sep 2020 15:00,18,7,11,128,59,69,44,18,26,70,40
Mon 7 Sep 2020 16:00,16,8,8,166,92,74,87,39,48,126,31
Mon 7 Sep 2020 17:00,24,13,11,250,149,101,123,53,70,183,68
Mon 7 Sep 2020 18:00,22,8,14,217,106,111,107,44,63,124,51
Mon 7 Sep 2020 19:00,18,10,8,140,63,77,76,39,37,94,41
Mon 7 Sep 2020 20:00,12,7,5,117,69,48,53,29,24,44,35
Mon 7 Sep 2020 21:00,8,2,6,54,34,20,37,14,23,30,20
Mon 7 Sep 2020 22:00,7,3,4,39,24,15,23,10,13,34,9
Mon 7 Sep 2020 23:00,1,1,0,25,18,7,9,4,5,16,7
Tue 8 Sep 2020 00:00,3,1,2,10,7,3,2,0,2,8,5
Tue 8 Sep 2020 01:00,1,0,1,5,1,4,0,0,0,3,2
Tue 8 Sep 2020 02:00,2,1,1,4,1,3,0,0,0,2,0
Tue 8 Sep 2020 03:00,0,0,0,7,5,2,1,1,0,4,0
Tue 8 Sep 2020 04:00,0,0,0,9,2,7,0,0,0,2,3
Tue 8 Sep 2020 05:00,1,1,0,21,2,19,14,10,4,5,16
Tue 8 Sep 2020 06:00,8,6,2,109,20,89,86,77,9,15,79
Tue 8 Sep 2020 07:00,14,9,5,245,68,177,138,117,21,21,154
Tue 8 Sep 2020 08:00,36,30,6,352,79,273,195,177,18,59,260
Tue 8 Sep 2020 09:00,14,13,1,152,39,113,97,85,12,27,86
Tue 8 Sep 2020 10:00,8,5,3,74,25,49,43,34,9,27,50
Tue 8 Sep 2020 11:00,8,5,3,84,26,58,53,40,13,40,68
Tue 8 Sep 2020 12:00,14,9,5,116,52,64,63,43,20,67,61
Tue 8 Sep 2020 13:00,7,5,2,135,51,84,60,41,19,75,64
Tue 8 Sep 2020 14:00,17,10,7,167,65,102,71,44,27,85,72
Tue 8 Sep 2020 15:00,16,9,7,172,84,88,61,33,28,98,60
Tue 8 Sep 2020 16:00,26,14,12,202,115,87,105,44,61,154,36
Tue 8 Sep 2020 17:00,24,9,15,359,194,165,155,68,87,231,50
Tue 8 Sep 2020 18:00,27,10,17,309,154,155,133,62,71,208,59
Tue 8 Sep 2020 19:00,20,4,16,193,96,97,74,40,34,106,39
Tue 8 Sep 2020 20:00,13,6,7,172,89,83,80,48,32,73,50
Tue 8 Sep 2020 21:00,8,2,6,81,50,31,37,15,22,58,29
Tue 8 Sep 2020 22:00,4,2,2,60,39,21,26,11,15,31,10
Tue 8 Sep 2020 23:00,2,1,1,47,38,9,10,5,5,26,5
Wed 9 Sep 2020 00:00,3,1,2,14,11,3,5,4,1,10,8
Wed 9 Sep 2020 01:00,0,0,0,4,3,1,5,2,3,5,2
Wed 9 Sep 2020 02:00,1,0,1,0,0,0,2,0,2,3,3
Wed 9 Sep 2020 03:00,1,1,0,7,2,5,3,1,2,2,2
Wed 9 Sep 2020 04:00,0,0,0,13,3,10,0,0,0,2,5
Wed 9 Sep 2020 05:00,1,1,0,18,0,18,9,8,1,6,18
Wed 9 Sep 2020 06:00,8,6,2,109,22,87,94,85,9,19,84
Wed 9 Sep 2020 07:00,13,11,2,239,59,180,141,125,16,21,152
Wed 9 Sep 2020 08:00,32,27,5,341,73,268,209,179,30,45,232
Wed 9 Sep 2020 09:00,20,10,10,162,32,130,98,89,9,29,107
Wed 9 Sep 2020 10:00,4,4,0,105,40,65,47,37,10,34,64
Wed 9 Sep 2020 11:00,7,6,1,102,40,62,56,43,13,34,40
Wed 9 Sep 2020 12:00,13,5,8,135,46,89,61,39,22,54,49
Wed 9 Sep 2020 13:00,7,5,2,157,77,80,50,38,12,82,48
Wed 9 Sep 2020 14:00,14,8,6,126,58,68,62,34,28,73,45
Wed 9 Sep 2020 15:00,10,5,5,155,79,76,73,41,32,92,46
Wed 9 Sep 2020 16:00,22,11,11,180,104,76,105,43,62,172,61
Wed 9 Sep 2020 17:00,30,15,15,316,179,137,182,70,112,248,54
Wed 9 Sep 2020 18:00,27,13,14,281,162,119,129,53,76,214,74
Wed 9 Sep 2020 19:00,23,12,11,217,106,111,86,41,45,105,58
Wed 9 Sep 2020 20:00,13,3,10,129,54,75,70,35,35,79,37
Wed 9 Sep 2020 21:00,5,0,5,76,47,29,37,18,19,46,21
Wed 9 Sep 2020 22:00,5,2,3,57,42,15,19,11,8,46,9
Wed 9 Sep 2020 23:00,1,0,1,46,35,11,21,9,12,31,10
Thu 10 Sep 2020 00:00,2,2,0,16,11,5,3,1,2,17,3
Thu 10 Sep 2020 01:00,2,1,1,3,2,1,0,0,0,4,2
Thu 10 Sep 2020 02:00,0,0,0,3,1,2,0,0,0,3,2
Thu 10 Sep 2020 03:00,0,0,0,5,2,3,1,1,0,1,1
Thu 10 Sep 2020 04:00,0,0,0,9,2,7,0,0,0,0,4
Thu 10 Sep 2020 05:00,1,1,0,21,0,21,9,7,2,8,17
Thu 10 Sep 2020 06:00,8,8,0,91,11,80,88,80,8,15,75
Thu 10 Sep 2020 07:00,16,12,4,258,68,190,118,103,15,27,169
Thu 10 Sep 2020 08:00,33,24,9,317,78,239,198,182,16,67,226
Thu 10 Sep 2020 09:00,15,11,4,167,40,127,104,95,9,36,105
Thu 10 Sep 2020 10:00,8,4,4,82,28,54,43,31,12,29,57
Thu 10 Sep 2020 11:00,8,4,4,89,36,53,39,30,9,36,44
Thu 10 Sep 2020 12:00,7,7,0,148,46,102,60,41,19,50,43
Thu 10 Sep 2020 13:00,9,5,4,138,57,81,75,39,36,76,48
Thu 10 Sep 2020 14:00,13,10,3,120,51,69,55,35,20,72,31
Thu 10 Sep 2020 15:00,14,8,6,168,81,87,68,31,37,91,44
Thu 10 Sep 2020 16:00,17,7,10,226,128,98,98,44,54,154,63
Thu 10 Sep 2020 17:00,29,13,16,324,173,151,166,73,93,219,73
Thu 10 Sep 2020 18:00,27,13,14,273,151,122,133,62,71,209,72
Thu 10 Sep 2020 19:00,13,6,7,183,97,86,84,41,43,93,28
Thu 10 Sep 2020 20:00,7,3,4,134,76,58,55,28,27,90,35
Thu 10 Sep 2020 21:00,10,6,4,93,59,34,38,17,21,57,21
Thu 10 Sep 2020 22:00,5,2,3,50,32,18,33,17,16,43,12
Thu 10 Sep 2020 23:00,1,0,1,50,40,10,11,3,8,28,10
Fri 11 Sep 2020 00:00,2,1,1,24,16,8,6,3,3,26,6
Fri 11 Sep 2020 01:00,2,2,0,9,6,3,2,1,1,7,1
Fri 11 Sep 2020 02:00,0,0,0,2,1,1,1,1,0,4,2
Fri 11 Sep 2020 03:00,0,0,0,4,3,1,2,2,0,3,2
Fri 11 Sep 2020 04:00,0,0,0,7,4,3,2,2,0,2,3
Fri 11 Sep 2020 05:00,1,1,0,26,3,23,9,8,1,6,17
Fri 11 Sep 2020 06:00,8,6,2,115,19,96,82,75,7,16,57
Fri 11 Sep 2020 07:00,12,11,1,210,51,159,124,113,11,28,134
Fri 11 Sep 2020 08:00,21,17,4,280,67,213,151,138,13,50,178
Fri 11 Sep 2020 09:00,18,11,7,154,34,120,108,89,19,23,60
Fri 11 Sep 2020 10:00,4,1,3,84,20,64,30,20,10,28,41
Fri 11 Sep 2020 11:00,9,6,3,81,30,51,40,31,9,44,39
Fri 11 Sep 2020 12:00,6,4,2,144,56,88,49,36,13,47,49
Fri 11 Sep 2020 13:00,16,10,6,139,63,76,73,39,34,85,37
Fri 11 Sep 2020 14:00,10,4,6,139,66,73,58,35,23,88,43
Fri 11 Sep 2020 15:00,14,8,6,165,88,77,71,41,30,71,37
Fri 11 Sep 2020 16:00,15,5,10,187,98,89,81,31,50,107,35
Fri 11 Sep 2020 17:00,23,8,15,293,171,122,134,46,88,169,54
Fri 11 Sep 2020 18:00,15,8,7,204,118,86,111,53,58,146,57
Fri 11 Sep 2020 19:00,9,3,6,192,86,106,72,41,31,88,22
Fri 11 Sep 2020 20:00,13,8,5,131,69,62,47,28,19,63,42
Fri 11 Sep 2020 21:00,9,6,3,81,39,42,42,21,21,34,37
Fri 11 Sep 2020 22:00,1,1,0,60,39,21,25,14,11,34,15
Fri 11 Sep 2020 23:00,0,0,0,54,42,12,25,6,19,42,19
Sat 12 Sep 2020 00:00,1,0,1,35,24,11,7,4,3,25,4
Sat 12 Sep 2020 01:00,1,1,0,19,11,8,4,4,0,9,5
Sat 12 Sep 2020 02:00,1,1,0,12,4,8,3,1,2,11,0
Sat 12 Sep 2020 03:00,1,1,0,9,5,4,0,0,0,1,2
Sat 12 Sep 2020 04:00,1,1,0,11,6,5,3,2,1,1,3
Sat 12 Sep 2020 05:00,0,0,0,16,1,15,3,3,0,3,5
Sat 12 Sep 2020 06:00,1,1,0,34,6,28,23,21,2,12,21
Sat 12 Sep 2020 07:00,2,1,1,50,19,31,46,41,5,16,41
Sat 12 Sep 2020 08:00,5,4,1,83,30,53,36,32,4,26,59
Sat 12 Sep 2020 09:00,18,16,2,71,23,48,57,47,10,29,57
Sat 12 Sep 2020 10:00,12,9,3,110,44,66,68,43,25,53,59
Sat 12 Sep 2020 11:00,8,8,0,151,48,103,85,52,33,64,69
Sat 12 Sep 2020 12:00,22,16,6,162,54,108,97,68,29,82,62
Sat 12 Sep 2020 13:00,9,5,4,143,58,85,114,59,55,78,88
Sat 12 Sep 2020 14:00,23,16,7,160,66,94,79,57,22,81,77
Sat 12 Sep 2020 15:00,15,9,6,155,68,87,77,45,32,85,64
Sat 12 Sep 2020 16:00,17,8,9,145,55,90,68,38,30,67,47
Sat 12 Sep 2020 17:00,16,9,7,145,72,73,87,54,33,86,44
Sat 12 Sep 2020 18:00,15,5,10,139,63,76,68,28,40,78,52
Sat 12 Sep 2020 19:00,10,4,6,125,73,52,53,32,21,67,42
Sat 12 Sep 2020 20:00,17,11,6,85,42,43,36,23,13,45,46
Sat 12 Sep 2020 21:00,9,5,4,87,56,31,29,15,14,43,15
Sat 12 Sep 2020 22:00,7,4,3,55,29,26,33,16,17,36,20
Sat 12 Sep 2020 23:00,5,1,4,45,28,17,23,10,13,32,10
Sun 13 Sep 2020 00:00,4,1,3,40,27,13,6,3,3,21,5
Sun 13 Sep 2020 01:00,0,0,0,21,14,7,4,3,1,12,4
Sun 13 Sep 2020 02:00,1,1,0,10,8,2,4,2,2,7,2
Sun 13 Sep 2020 03:00,0,0,0,3,2,1,3,3,0,5,1
Sun 13 Sep 2020 04:00,1,1,0,7,5,2,0,0,0,3,2
Sun 13 Sep 2020 05:00,0,0,0,10,2,8,4,4,0,3,3
Sun 13 Sep 2020 06:00,1,1,0,23,4,19,16,16,0,5,19
Sun 13 Sep 2020 07:00,1,1,0,53,13,40,28,25,3,11,20
Sun 13 Sep 2020 08:00,5,4,1,44,12,32,28,23,5,26,33
Sun 13 Sep 2020 09:00,5,1,4,103,27,76,46,30,16,36,59
Sun 13 Sep 2020 10:00,10,7,3,122,32,90,59,39,20,56,52
Sun 13 Sep 2020 11:00,13,9,4,155,29,126,79,60,19,76,48
Sun 13 Sep 2020 12:00,24,19,5,169,52,117,116,68,48,115,66
Sun 13 Sep 2020 13:00,14,9,5,180,66,114,112,67,45,118,62
Sun 13 Sep 2020 14:00,28,15,13,138,45,93,100,56,44,117,82
Sun 13 Sep 2020 15:00,28,15,13,157,63,94,98,62,36,93,80
Sun 13 Sep 2020 16:00,18,8,10,145,61,84,82,51,31,71,80
Sun 13 Sep 2020 17:00,29,19,10,137,66,71,84,49,35,78,95
Sun 13 Sep 2020 18:00,23,10,13,145,75,70,79,39,40,85,79
Sun 13 Sep 2020 19:00,17,5,12,174,95,79,91,55,36,63,86
Sun 13 Sep 2020 20:00,7,1,6,137,65,72,63,19,44,42,46
Sun 13 Sep 2020 21:00,5,4,1,67,37,30,30,11,19,37,19
Sun 13 Sep 2020 22:00,5,4,1,68,50,18,15,9,6,36,17
Sun 13 Sep 2020 23:00,2,2,0,32,24,8,8,5,3,18,5
Mon 14 Sep 2020 00:00,0,0,0,18,10,8,7,4,3,8,3
Mon 14 Sep 2020 01:00,0,0,0,10,8,2,2,0,2,4,3
Mon 14 Sep 2020 02:00,0,0,0,6,5,1,2,2,0,3,8
Mon 14 Sep 2020 03:00,2,2,0,3,2,1,2,2,0,3,0
Mon 14 Sep 2020 04:00,0,0,0,7,4,3,1,1,0,0,1
Mon 14 Sep 2020 05:00,1,1,0,23,0,23,11,10,1,2,26
Mon 14 Sep 2020 06:00,5,5,0,91,18,73,85,79,6,14,75
Mon 14 Sep 2020 07:00,15,14,1,240,65,175,127,109,18,24,137
Mon 14 Sep 2020 08:00,22,15,7,332,74,258,166,146,20,65,218
Mon 14 Sep 2020 09:00,18,10,8,157,33,124,93,78,15,33,122
Mon 14 Sep 2020 10:00,8,8,0,81,28,53,46,38,8,24,54
Mon 14 Sep 2020 11:00,11,4,7,106,36,70,51,38,13,32,45
Mon 14 Sep 2020 12:00,10,5,5,145,47,98,71,50,21,44,62
Mon 14 Sep 2020 13:00,13,9,4,156,75,81,66,39,27,95,41
Mon 14 Sep 2020 14:00,16,7,9,148,67,81,73,47,26,102,55
Mon 14 Sep 2020 15:00,19,8,11,171,91,80,82,32,50,111,71
Mon 14 Sep 2020 16:00,28,13,15,212,123,89,108,41,67,170,61
Mon 14 Sep 2020 17:00,29,9,20,307,178,129,180,77,103,200,63
Mon 14 Sep 2020 18:00,20,8,12,271,139,132,140,53,87,187,68
Mon 14 Sep 2020 19:00,18,6,12,192,105,87,93,46,47,120,45
Mon 14 Sep 2020 20:00,9,3,6,123,69,54,57,29,28,56,23
Mon 14 Sep 2020 21:00,7,6,1,78,48,30,28,12,16,59,12
Mon 14 Sep 2020 22:00,1,1,0,39,26,13,18,9,9,26,11
Mon 14 Sep 2020 23:00,2,2,0,34,17,17,20,7,13,20,5
Tue 15 Sep 2020 00:00,0,0,0,13,10,3,3,1,2,6,4
Tue 15 Sep 2020 01:00,1,1,0,5,1,4,2,1,1,6,3
Tue 15 Sep 2020 02:00,0,0,0,1,0,1,0,0,0,2,1
Tue 15 Sep 2020 03:00,0,0,0,5,4,1,1,1,0,1,0
Tue 15 Sep 2020 04:00,0,0,0,7,2,5,1,1,0,0,3
Tue 15 Sep 2020 05:00,1,1,0,18,3,15,11,9,2,4,17
Tue 15 Sep 2020 06:00,9,7,2,104,21,83,90,83,7,14,68
Tue 15 Sep 2020 07:00,10,9,1,237,55,182,118,105,13,29,142
Tue 15 Sep 2020 08:00,20,18,2,342,73,269,176,159,17,50,233
Tue 15 Sep 2020 09:00,15,11,4,170,34,136,72,56,16,26,128
Tue 15 Sep 2020 10:00,9,6,3,96,34,62,49,40,9,21,51
Tue 15 Sep 2020 11:00,8,7,1,108,33,75,52,33,19,42,33
Tue 15 Sep 2020 12:00,12,7,5,154,54,100,38,31,7,78,63
Tue 15 Sep 2020 13:00,14,7,7,138,57,81,48,23,25,88,42
Tue 15 Sep 2020 14:00,17,11,6,137,67,70,83,47,36,77,31
Tue 15 Sep 2020 15:00,20,10,10,155,78,77,77,34,43,111,43
Tue 15 Sep 2020 16:00,19,9,10,216,105,111,131,51,80,173,50
Tue 15 Sep 2020 17:00,30,16,14,392,219,173,167,56,111,255,70
Tue 15 Sep 2020 18:00,26,17,9,336,172,164,173,88,85,220,84
Tue 15 Sep 2020 19:00,20,8,12,286,151,135,103,57,46,113,86
Tue 15 Sep 2020 20:00,14,9,5,187,106,81,73,33,40,78,77
Tue 15 Sep 2020 21:00,11,6,5,120,67,53,54,27,27,57,22
Tue 15 Sep 2020 22:00,4,4,0,73,44,29,43,21,22,35,13
Tue 15 Sep 2020 23:00,1,0,1,43,33,10,19,9,10,26,10
Wed 16 Sep 2020 00:00,1,1,0,19,14,5,6,2,4,13,4
Wed 16 Sep 2020 01:00,0,0,0,9,8,1,3,2,1,4,4
Wed 16 Sep 2020 02:00,3,1,2,6,5,1,0,0,0,2,1
Wed 16 Sep 2020 03:00,0,0,0,5,4,1,0,0,0,3,1
Wed 16 Sep 2020 04:00,0,0,0,15,7,8,1,1,0,1,5
Wed 16 Sep 2020 05:00,1,1,0,23,2,21,11,9,2,2,13
Wed 16 Sep 2020 06:00,4,4,0,104,17,87,95,85,10,20,72
Wed 16 Sep 2020 07:00,16,14,2,257,69,188,144,127,17,33,184
Wed 16 Sep 2020 08:00,36,25,11,387,93,294,204,185,19,58,228
Wed 16 Sep 2020 09:00,14,9,5,174,33,141,117,101,16,32,131
Wed 16 Sep 2020 10:00,11,7,4,104,36,68,57,37,20,43,52
Wed 16 Sep 2020 11:00,19,14,5,114,29,85,58,43,15,58,42
Wed 16 Sep 2020 12:00,10,4,6,163,49,114,76,45,31,77,71
Wed 16 Sep 2020 13:00,14,9,5,171,80,91,91,44,47,76,62
Wed 16 Sep 2020 14:00,23,12,11,145,57,88,70,34,36,109,60
Wed 16 Sep 2020 15:00,19,12,7,148,76,72,35,19,16,99,55
Wed 16 Sep 2020 16:00,17,6,11,216,120,96,15,9,6,163,62
Wed 16 Sep 2020 17:00,18,4,14,398,243,155,120,53,67,239,52
Wed 16 Sep 2020 18:00,21,6,15,285,151,134,123,46,77,220,71
Wed 16 Sep 2020 19:00,13,4,9,178,89,89,112,60,52,74,56
Wed 16 Sep 2020 20:00,8,6,2,163,81,82,69,29,40,90,25
Wed 16 Sep 2020 21:00,5,3,2,80,59,21,38,13,25,60,25
Wed 16 Sep 2020 22:00,4,1,3,71,53,18,27,11,16,43,27
Wed 16 Sep 2020 23:00,3,3,0,47,39,8,11,5,6,27,8
Thu 17 Sep 2020 00:00,3,1,2,13,8,5,1,1,0,14,2
Thu 17 Sep 2020 01:00,0,0,0,6,4,2,2,0,2,10,2
Thu 17 Sep 2020 02:00,0,0,0,2,2,0,0,0,0,3,3
Thu 17 Sep 2020 03:00,0,0,0,3,1,2,0,0,0,1,0
Thu 17 Sep 2020 04:00,1,0,1,7,2,5,1,1,0,4,2
Thu 17 Sep 2020 05:00,0,0,0,21,2,19,12,11,1,3,19
Thu 17 Sep 2020 06:00,4,4,0,112,25,87,101,92,9,14,71
Thu 17 Sep 2020 07:00,12,12,0,257,65,192,123,108,15,41,142
Thu 17 Sep 2020 08:00,31,25,6,347,71,276,183,160,23,76,215
Thu 17 Sep 2020 09:00,17,13,4,189,54,135,107,93,14,40,113
Thu 17 Sep 2020 10:00,10,7,3,98,31,67,53,37,16,24,62
Thu 17 Sep 2020 11:00,11,7,4,130,47,83,59,41,18,44,51
Thu 17 Sep 2020 12:00,19,9,10,151,55,96,76,48,28,75,94
Thu 17 Sep 2020 13:00,17,12,5,154,61,93,78,48,30,88,62
Thu 17 Sep 2020 14:00,13,7,6,159,66,93,62,28,34,91,64
Thu 17 Sep 2020 15:00,23,15,8,195,98,97,83,40,43,109,79
Thu 17 Sep 2020 16:00,16,8,8,209,111,98,139,59,80,160,75
Thu 17 Sep 2020 17:00,19,9,10,385,205,180,162,81,81,249,83
Thu 17 Sep 2020 18:00,32,18,14,305,169,136,172,78,94,225,100
Thu 17 Sep 2020 19:00,15,5,10,212,109,103,77,32,45,131,73
Thu 17 Sep 2020 20:00,18,12,6,163,90,73,85,45,40,96,52
Thu 17 Sep 2020 21:00,14,2,12,94,58,36,57,17,40,58,30
Thu 17 Sep 2020 22:00,8,5,3,72,45,27,31,15,16,51,19
Thu 17 Sep 2020 23:00,5,3,2,57,40,17,16,8,8,41,21
Fri 18 Sep 2020 00:00,0,0,0,25,18,7,11,5,6,25,9
Fri 18 Sep 2020 01:00,0,0,0,9,9,0,3,2,1,8,2
Fri 18 Sep 2020 02:00,0,0,0,4,3,1,3,3,0,1,1
Fri 18 Sep 2020 03:00,0,0,0,4,2,2,1,0,1,2,0
Fri 18 Sep 2020 04:00,1,0,1,10,5,5,3,3,0,3,3
Fri 18 Sep 2020 05:00,0,0,0,22,0,22,12,10,2,5,19
Fri 18 Sep 2020 06:00,10,8,2,106,17,89,81,76,5,15,55
Fri 18 Sep 2020 07:00,8,7,1,233,70,163,130,110,20,31,141
Fri 18 Sep 2020 08:00,30,25,5,307,80,227,176,159,17,62,183
Fri 18 Sep 2020 09:00,15,10,5,168,40,128,85,70,15,27,89
Fri 18 Sep 2020 10:00,10,7,3,106,26,80,58,45,13,36,62
Fri 18 Sep 2020 11:00,19,10,9,98,42,56,64,50,14,46,45
Fri 18 Sep 2020 12:00,13,12,1,156,48,108,77,54,23,63,62
Fri 18 Sep 2020 13:00,14,8,6,157,62,95,88,53,35,93,53
Fri 18 Sep 2020 14:00,11,4,7,145,63,82,80,37,43,100,49
Fri 18 Sep 2020 15:00,13,5,8,173,91,82,81,36,45,115,38
Fri 18 Sep 2020 16:00,20,9,11,219,127,92,107,50,57,139,42
Fri 18 Sep 2020 17:00,24,9,15,270,163,107,150,63,87,198,63
Fri 18 Sep 2020 18:00,4,2,2,221,123,98,85,42,43,122,54
Fri 18 Sep 2020 19:00,8,4,4,219,119,100,84,61,23,87,52
Fri 18 Sep 2020 20:00,5,1,4,161,71,90,53,25,28,67,34
Fri 18 Sep 2020 21:00,5,1,4,79,44,35,44,24,20,49,26
Fri 18 Sep 2020 22:00,4,3,1,55,33,22,29,13,16,42,20
Fri 18 Sep 2020 23:00,3,3,0,59,47,12,22,8,14,44,12
Sat 19 Sep 2020 00:00,5,3,2,48,30,18,11,4,7,19,7
Sat 19 Sep 2020 01:00,1,0,1,17,8,9,5,3,2,7,6
Sat 19 Sep 2020 02:00,1,1,0,10,7,3,3,3,0,10,4
Sat 19 Sep 2020 03:00,0,0,0,12,8,4,6,0,6,6,1
Sat 19 Sep 2020 04:00,0,0,0,14,9,5,2,2,0,4,4
Sat 19 Sep 2020 05:00,1,1,0,7,0,7,2,2,0,3,3
Sat 19 Sep 2020 06:00,2,2,0,39,4,35,25,24,1,16,23
Sat 19 Sep 2020 07:00,5,4,1,56,12,44,47,42,5,16,34
Sat 19 Sep 2020 08:00,11,7,4,70,22,48,33,23,10,27,37
Sat 19 Sep 2020 09:00,10,8,2,84,27,57,52,44,8,49,56
Sat 19 Sep 2020 10:00,16,6,10,115,36,79,70,43,27,41,56
Sat 19 Sep 2020 11:00,16,6,10,110,34,76,65,42,23,42,48
Sat 19 Sep 2020 12:00,18,11,7,135,50,85,70,48,22,78,60
Sat 19 Sep 2020 13:00,18,10,8,135,70,65,83,41,42,89,72
Sat 19 Sep 2020 14:00,27,12,15,177,79,98,88,44,44,98,79
Sat 19 Sep 2020 15:00,13,8,5,155,78,77,66,37,29,72,49
Sat 19 Sep 2020 16:00,13,5,8,116,58,58,56,29,27,90,45
Sat 19 Sep 2020 17:00,18,7,11,103,61,42,67,39,28,87,62
Sat 19 Sep 2020 18:00,8,4,4,165,87,78,71,48,23,89,60
Sat 19 Sep 2020 19:00,11,7,4,121,63,58,69,43,26,64,51
Sat 19 Sep 2020 20:00,5,4,1,79,44,35,41,31,10,49,46
Sat 19 Sep 2020 21:00,10,2,8,64,41,23,34,14,20,47,22
Sat 19 Sep 2020 22:00,4,3,1,44,32,12,22,10,12,29,15
Sat 19 Sep 2020 23:00,3,2,1,54,34,20,13,8,5,18,9
Sun 20 Sep 2020 00:00,1,1,0,21,9,12,9,3,6,13,8
Sun 20 Sep 2020 01:00,1,0,1,14,7,7,5,4,1,8,2
Sun 20 Sep 2020 02:00,0,0,0,8,4,4,0,0,0,4,2
Sun 20 Sep 2020 03:00,0,0,0,5,5,0,0,0,0,3,1
Sun 20 Sep 2020 04:00,0,0,0,4,2,2,1,0,1,1,1
Sun 20 Sep 2020 05:00,0,0,0,3,2,1,1,1,0,3,1
Sun 20 Sep 2020 06:00,3,3,0,28,9,19,11,11,0,10,14
Sun 20 Sep 2020 07:00,2,1,1,35,5,30,25,21,4,20,29
Sun 20 Sep 2020 08:00,4,3,1,46,12,34,20,16,4,32,24
Sun 20 Sep 2020 09:00,3,3,0,66,27,39,39,22,17,41,40
Sun 20 Sep 2020 10:00,13,7,6,90,29,61,68,42,26,52,53
Sun 20 Sep 2020 11:00,25,14,11,96,32,64,77,47,30,75,62
Sun 20 Sep 2020 12:00,22,11,11,170,77,93,102,63,39,83,65
Sun 20 Sep 2020 13:00,30,15,15,146,64,82,93,54,39,87,69
Sun 20 Sep 2020 14:00,15,13,2,149,61,88,104,66,38,85,50
Sun 20 Sep 2020 15:00,20,12,8,154,61,93,107,66,41,78,55
Sun 20 Sep 2020 16:00,16,12,4,130,65,65,81,41,40,67,91
Sun 20 Sep 2020 17:00,6,3,3,117,68,49,68,40,28,73,57
Sun 20 Sep 2020 18:00,20,9,11,134,76,58,63,35,28,55,34
Sun 20 Sep 2020 19:00,10,2,8,136,75,61,62,36,26,47,30
Sun 20 Sep 2020 20:00,11,6,5,82,48,34,48,24,24,51,26
Sun 20 Sep 2020 21:00,6,1,5,53,28,25,31,21,10,34,8
Sun 20 Sep 2020 22:00,2,1,1,36,24,12,21,12,9,18,14
Sun 20 Sep 2020 23:00,3,1,2,18,11,7,11,4,7,16,5
Mon 21 Sep 2020 00:00,1,0,1,9,5,4,1,1,0,4,4
Mon 21 Sep 2020 01:00,0,0,0,4,4,0,1,0,1,3,2
Mon 21 Sep 2020 02:00,0,0,0,1,1,0,2,2,0,3,1
Mon 21 Sep 2020 03:00,0,0,0,3,1,2,1,1,0,0,0
Mon 21 Sep 2020 04:00,0,0,0,8,3,5,0,0,0,0,3
Mon 21 Sep 2020 05:00,1,1,0,26,1,25,13,10,3,4,18
Mon 21 Sep 2020 06:00,6,6,0,110,18,92,88,83,5,9,74
Mon 21 Sep 2020 07:00,14,12,2,233,65,168,126,111,15,33,147
Mon 21 Sep 2020 08:00,30,22,8,330,92,238,156,141,15,54,205
Mon 21 Sep 2020 09:00,19,9,10,156,36,120,73,52,21,34,111
Mon 21 Sep 2020 10:00,7,5,2,101,28,73,54,33,21,37,34
Mon 21 Sep 2020 11:00,10,3,7,95,42,53,57,37,20,32,55
Mon 21 Sep 2020 12:00,16,10,6,138,47,91,51,29,22,75,49
Mon 21 Sep 2020 13:00,11,7,4,169,60,109,66,47,19,67,46
Mon 21 Sep 2020 14:00,16,10,6,135,59,76,72,47,25,94,34
Mon 21 Sep 2020 15:00,21,15,6,164,69,95,70,31,39,110,60
Mon 21 Sep 2020 16:00,22,13,9,216,120,96,112,48,64,165,69
Mon 21 Sep 2020 17:00,29,15,14,394,211,183,167,66,101,233,90
Mon 21 Sep 2020 18:00,26,14,12,328,171,157,132,59,73,207,81
Mon 21 Sep 2020 19:00,9,5,4,190,103,87,92,53,39,92,60
Mon 21 Sep 2020 20:00,16,7,9,153,88,65,45,18,27,49,50
Mon 21 Sep 2020 21:00,7,4,3,80,51,29,29,9,20,43,20
Mon 21 Sep 2020 22:00,3,2,1,50,39,11,16,10,6,29,9
Mon 21 Sep 2020 23:00,1,0,1,23,11,12,13,6,7,25,7
Tue 22 Sep 2020 00:00,0,0,0,19,11,8,0,0,0,12,3
Tue 22 Sep 2020 01:00,0,0,0,6,6,0,2,1,1,3,1
Tue 22 Sep 2020 02:00,1,1,0,4,0,4,0,0,0,1,4
Tue 22 Sep 2020 03:00,0,0,0,1,1,0,1,1,0,2,1
Tue 22 Sep 2020 04:00,0,0,0,11,6,5,0,0,0,0,2
Tue 22 Sep 2020 05:00,1,1,0,21,2,19,15,13,2,2,17
Tue 22 Sep 2020 06:00,5,5,0,115,21,94,85,81,4,15,73
Tue 22 Sep 2020 07:00,23,19,4,246,64,182,132,107,25,25,143
Tue 22 Sep 2020 08:00,31,23,8,342,88,254,169,154,15,64,246
Tue 22 Sep 2020 09:00,9,7,2,154,35,119,79,67,12,38,107
Tue 22 Sep 2020 10:00,7,6,1,92,34,58,46,38,8,32,56
Tue 22 Sep 2020 11:00,7,3,4,91,34,57,53,38,15,28,46
Tue 22 Sep 2020 12:00,17,11,6,141,57,84,58,36,22,47,52
Tue 22 Sep 2020 13:00,13,7,6,152,64,88,62,36,26,69,49
Tue 22 Sep 2020 14:00,13,6,7,134,60,74,61,38,23,70,58
Tue 22 Sep 2020 15:00,18,12,6,145,81,64,77,39,38,117,45
Tue 22 Sep 2020 16:00,20,12,8,195,119,76,99,39,60,151,59
Tue 22 Sep 2020 17:00,35,16,19,332,190,142,168,69,99,191,49
Tue 22 Sep 2020 18:00,14,5,9,277,158,119,132,65,67,182,46
Tue 22 Sep 2020 19:00,7,1,6,188,108,80,76,36,40,101,36
Tue 22 Sep 2020 20:00,8,3,5,120,66,54,41,13,28,62,36
Tue 22 Sep 2020 21:00,2,2,0,63,43,20,31,17,14,34,17
Tue 22 Sep 2020 22:00,3,1,2,35,23,12,21,13,8,21,9
Tue 22 Sep 2020 23:00,0,0,0,20,12,8,8,2,6,9,3
Wed 23 Sep 2020 00:00,2,2,0,7,5,2,2,0,2,8,2
Wed 23 Sep 2020 01:00,0,0,0,2,2,0,3,2,1,5,1
Wed 23 Sep 2020 02:00,0,0,0,1,0,1,0,0,0,0,1
Wed 23 Sep 2020 03:00,0,0,0,3,2,1,0,0,0,1,0
Wed 23 Sep 2020 04:00,0,0,0,11,5,6,2,1,1,1,2
Wed 23 Sep 2020 05:00,0,0,0,22,0,22,16,14,2,3,23
Wed 23 Sep 2020 06:00,7,6,1,97,17,80,94,87,7,13,74
Wed 23 Sep 2020 07:00,21,17,4,218,57,161,133,117,16,25,153
Wed 23 Sep 2020 08:00,39,28,11,341,68,273,171,156,15,50,240
Wed 23 Sep 2020 09:00,11,7,4,169,46,123,82,69,13,27,85
Wed 23 Sep 2020 10:00,7,5,2,91,29,62,44,29,15,25,51
Wed 23 Sep 2020 11:00,13,9,4,107,39,68,59,44,15,35,40
Wed 23 Sep 2020 12:00,18,11,7,142,57,85,86,58,28,65,44
Wed 23 Sep 2020 13:00,17,7,10,164,79,85,68,36,32,54,41
Wed 23 Sep 2020 14:00,17,12,5,152,65,87,63,44,19,80,33
Wed 23 Sep 2020 15:00,13,9,4,147,88,59,77,38,39,88,40
Wed 23 Sep 2020 16:00,19,8,11,231,112,119,109,51,58,139,46
Wed 23 Sep 2020 17:00,34,20,14,299,190,109,185,64,121,235,53
Wed 23 Sep 2020 18:00,23,7,16,298,168,130,116,55,61,186,77
Wed 23 Sep 2020 19:00,12,7,5,209,112,97,102,58,44,123,36
Wed 23 Sep 2020 20:00,10,5,5,135,83,52,63,33,30,48,40
Wed 23 Sep 2020 21:00,8,3,5,74,46,28,34,18,16,56,37
Wed 23 Sep 2020 22:00,5,3,2,48,35,13,26,7,19,35,11
Wed 23 Sep 2020 23:00,1,1,0,26,17,9,6,2,4,23,12
Thu 24 Sep 2020 00:00,0,0,0,14,10,4,4,2,2,10,5
Thu 24 Sep 2020 01:00,0,0,0,4,1,3,2,2,0,3,1
Thu 24 Sep 2020 02:00,0,0,0,0,0,0,0,0,0,4,1
Thu 24 Sep 2020 03:00,0,0,0,4,2,2,0,0,0,0,0
Thu 24 Sep 2020 04:00,0,0,0,7,3,4,1,1,0,2,1
Thu 24 Sep 2020 05:00,1,1,0,22,1,21,12,11,1,4,12
Thu 24 Sep 2020 06:00,7,7,0,81,20,61,65,59,6,17,43
Thu 24 Sep 2020 07:00,10,9,1,158,37,121,93,83,10,19,101
Thu 24 Sep 2020 08:00,22,18,4,272,64,208,141,126,15,51,192
Thu 24 Sep 2020 09:00,12,10,2,136,29,107,80,67,13,20,79
Thu 24 Sep 2020 10:00,5,3,2,80,29,51,43,28,15,20,29
Thu 24 Sep 2020 11:00,9,2,7,84,22,62,40,33,7,21,29
Thu 24 Sep 2020 12:00,5,3,2,116,38,78,37,21,16,37,31
Thu 24 Sep 2020 13:00,9,5,4,135,59,76,38,23,15,51,35
Thu 24 Sep 2020 14:00,20,12,8,99,45,54,49,32,17,38,11
Thu 24 Sep 2020 15:00,16,11,5,116,61,55,54,29,25,71,44
Thu 24 Sep 2020 16:00,13,7,6,152,89,63,66,33,33,100,33
Thu 24 Sep 2020 17:00,22,13,9,261,156,105,119,57,62,154,27
Thu 24 Sep 2020 18:00,15,3,12,204,115,89,89,28,61,124,14
Thu 24 Sep 2020 19:00,10,3,7,128,75,53,62,31,31,56,8
Thu 24 Sep 2020 20:00,4,2,2,93,55,38,32,15,17,48,20
Thu 24 Sep 2020 21:00,2,2,0,68,46,22,39,16,23,36,16
Thu 24 Sep 2020 22:00,2,1,1,39,29,10,15,8,7,15,6
Thu 24 Sep 2020 23:00,2,2,0,20,14,6,7,3,4,17,3
Fri 25 Sep 2020 00:00,1,0,1,11,10,1,6,1,5,8,1
Fri 25 Sep 2020 01:00,1,0,1,2,1,1,2,0,2,1,0
Fri 25 Sep 2020 02:00,0,0,0,1,1,0,0,0,0,2,2
Fri 25 Sep 2020 03:00,0,0,0,3,1,2,1,1,0,1,0
Fri 25 Sep 2020 04:00,2,2,0,9,4,5,1,1,0,1,2
Fri 25 Sep 2020 05:00,0,0,0,23,2,21,14,13,1,4,17
Fri 25 Sep 2020 06:00,8,8,0,85,11,74,75,69,6,14,61
Fri 25 Sep 2020 07:00,10,8,2,205,56,149,123,105,18,31,124
Fri 25 Sep 2020 08:00,26,24,2,321,76,245,163,143,20,51,205
Fri 25 Sep 2020 09:00,11,9,2,164,38,126,82,70,12,30,69
Fri 25 Sep 2020 10:00,9,7,2,104,24,80,52,36,16,25,33
Fri 25 Sep 2020 11:00,16,11,5,103,39,64,61,41,20,44,42
Fri 25 Sep 2020 12:00,18,9,9,156,54,102,92,47,45,57,37
Fri 25 Sep 2020 13:00,12,5,7,180,74,106,81,51,30,80,39
Fri 25 Sep 2020 14:00,25,12,13,134,53,81,77,40,37,76,47
Fri 25 Sep 2020 15:00,9,7,2,161,96,65,64,33,31,85,38
Fri 25 Sep 2020 16:00,16,6,10,190,100,90,111,46,65,128,30
Fri 25 Sep 2020 17:00,18,7,11,287,163,124,133,56,77,180,58
Fri 25 Sep 2020 18:00,8,2,6,242,124,118,103,47,56,172,60
Fri 25 Sep 2020 19:00,20,12,8,200,103,97,89,68,21,102,54
Fri 25 Sep 2020 20:00,11,5,6,108,60,48,54,29,25,60,40
Fri 25 Sep 2020 21:00,3,1,2,80,49,31,35,19,16,51,14
Fri 25 Sep 2020 22:00,11,3,8,69,46,23,29,11,18,30,13
Fri 25 Sep 2020 23:00,2,1,1,46,31,15,11,5,6,22,12
Sat 26 Sep 2020 00:00,1,1,0,26,17,9,16,8,8,16,6
Sat 26 Sep 2020 01:00,2,1,1,17,13,4,4,1,3,11,2
Sat 26 Sep 2020 02:00,1,1,0,5,3,2,0,0,0,5,2
Sat 26 Sep 2020 03:00,0,0,0,6,2,4,2,2,0,2,2
Sat 26 Sep 2020 04:00,0,0,0,7,6,1,3,3,0,3,5
Sat 26 Sep 2020 05:00,0,0,0,14,4,10,1,1,0,1,2
Sat 26 Sep 2020 06:00,0,0,0,32,7,25,27,24,3,10,21
Sat 26 Sep 2020 07:00,4,1,3,55,13,42,40,34,6,15,33
Sat 26 Sep 2020 08:00,5,4,1,94,47,47,37,27,10,33,34
Sat 26 Sep 2020 09:00,16,13,3,116,33,83,66,50,16,45,59
Sat 26 Sep 2020 10:00,16,7,9,115,40,75,63,37,26,76,78
Sat 26 Sep 2020 11:00,22,17,5,165,58,107,96,61,35,89,70
Sat 26 Sep 2020 12:00,21,11,10,202,97,105,118,72,46,104,80
Sat 26 Sep 2020 13:00,22,11,11,169,69,100,116,62,54,140,80
Sat 26 Sep 2020 14:00,27,12,15,190,81,109,131,74,57,120,70
Sat 26 Sep 2020 15:00,23,15,8,144,76,68,109,58,51,89,94
Sat 26 Sep 2020 16:00,42,19,23,135,53,82,85,44,41,86,72
Sat 26 Sep 2020 17:00,13,9,4,157,77,80,85,43,42,83,78
Sat 26 Sep 2020 18:00,11,3,8,177,96,81,73,48,25,71,74
Sat 26 Sep 2020 19:00,9,3,6,155,77,78,64,45,19,62,64
Sat 26 Sep 2020 20:00,13,7,6,114,57,57,40,23,17,60,38
Sat 26 Sep 2020 21:00,9,2,7,77,48,29,41,19,22,40,33
Sat 26 Sep 2020 22:00,1,0,1,52,33,19,28,12,16,27,21
Sat 26 Sep 2020 23:00,3,3,0,44,29,15,18,6,12,22,10
Sun 27 Sep 2020 00:00,1,0,1,25,15,10,10,6,4,15,3
Sun 27 Sep 2020 01:00,0,0,0,13,8,5,3,1,2,8,6
Sun 27 Sep 2020 02:00,0,0,0,7,4,3,0,0,0,7,4
Sun 27 Sep 2020 03:00,0,0,0,7,3,4,0,0,0,3,0
Sun 27 Sep 2020 04:00,0,0,0,7,4,3,3,2,1,2,3
Sun 27 Sep 2020 05:00,0,0,0,9,3,6,0,0,0,2,5
Sun 27 Sep 2020 06:00,0,0,0,16,4,12,7,5,2,6,8
Sun 27 Sep 2020 07:00,1,1,0,42,12,30,27,21,6,12,17
Sun 27 Sep 2020 08:00,7,5,2,76,40,36,33,27,6,58,35
Sun 27 Sep 2020 09:00,9,4,5,99,28,71,52,30,22,46,41
Sun 27 Sep 2020 10:00,14,6,8,118,38,80,91,42,49,75,53
Sun 27 Sep 2020 11:00,27,9,18,157,43,114,98,46,52,86,48
Sun 27 Sep 2020 12:00,22,15,7,159,42,117,117,74,43,97,75
Sun 27 Sep 2020 13:00,26,13,13,200,84,116,127,74,53,121,96
Sun 27 Sep 2020 14:00,34,19,15,182,62,120,125,62,63,80,82
Sun 27 Sep 2020 15:00,16,9,7,182,78,104,127,74,53,89,79
Sun 27 Sep 2020 16:00,35,12,23,175,92,83,96,51,45,88,81
Sun 27 Sep 2020 17:00,19,11,8,168,80,88,104,60,44,89,84
Sun 27 Sep 2020 18:00,17,8,9,172,95,77,87,53,34,75,79
Sun 27 Sep 2020 19:00,13,5,8,141,71,70,51,26,25,59,48
Sun 27 Sep 2020 20:00,24,4,20,78,36,42,37,21,16,46,29
Sun 27 Sep 2020 21:00,12,8,4,73,50,23,46,25,21,33,15
Sun 27 Sep 2020 22:00,0,0,0,41,31,10,16,10,6,22,16
Sun 27 Sep 2020 23:00,1,1,0,25,19,6,10,7,3,12,8
Mon 28 Sep 2020 00:00,0,0,0,15,10,5,3,1,2,9,1
Mon 28 Sep 2020 01:00,1,1,0,1,0,1,4,0,4,7,2
Mon 28 Sep 2020 02:00,0,0,0,2,1,1,1,0,1,4,1
Mon 28 Sep 2020 03:00,0,0,0,4,3,1,1,1,0,1,0
Mon 28 Sep 2020 04:00,0,0,0,10,5,5,0,0,0,0,7
Mon 28 Sep 2020 05:00,2,2,0,29,3,26,14,12,2,3,24
Mon 28 Sep 2020 06:00,9,9,0,85,11,74,84,80,4,16,53
Mon 28 Sep 2020 07:00,16,11,5,194,59,135,129,106,23,26,138
Mon 28 Sep 2020 08:00,30,24,6,311,78,233,143,135,8,48,176
Mon 28 Sep 2020 09:00,16,11,5,150,42,108,78,63,15,25,93
Mon 28 Sep 2020 10:00,3,2,1,69,22,47,29,24,5,20,43
Mon 28 Sep 2020 11:00,10,3,7,76,24,52,46,37,9,28,38
Mon 28 Sep 2020 12:00,2,1,1,109,35,74,48,26,22,44,34
Mon 28 Sep 2020 13:00,11,9,2,128,59,69,58,40,18,45,37
Mon 28 Sep 2020 14:00,14,8,6,119,52,67,51,34,17,52,30
Mon 28 Sep 2020 15:00,15,7,8,134,64,70,52,35,17,73,57
Mon 28 Sep 2020 16:00,23,11,12,219,121,98,104,37,67,126,49
Mon 28 Sep 2020 17:00,21,6,15,308,179,129,156,60,96,225,57
Mon 28 Sep 2020 18:00,21,7,14,258,142,116,116,44,72,188,48
Mon 28 Sep 2020 19:00,18,10,8,137,74,63,81,38,43,90,43
Mon 28 Sep 2020 20:00,13,6,7,88,38,50,39,24,15,50,22
Mon 28 Sep 2020 21:00,5,3,2,78,52,26,24,11,13,37,22
Mon 28 Sep 2020 22:00,3,0,3,31,23,8,14,9,5,33,7
Mon 28 Sep 2020 23:00,2,2,0,23,19,4,11,6,5,14,5
Tue 29 Sep 2020 00:00,0,0,0,9,5,4,3,0,3,8,2
Tue 29 Sep 2020 01:00,0,0,0,6,2,4,1,1,0,4,1
Tue 29 Sep 2020 02:00,1,1,0,1,0,1,0,0,0,5,1
Tue 29 Sep 2020 03:00,0,0,0,3,2,1,2,2,0,1,0
Tue 29 Sep 2020 04:00,1,1,0,7,4,3,0,0,0,2,7
Tue 29 Sep 2020 05:00,2,2,0,32,4,28,15,13,2,4,16
Tue 29 Sep 2020 06:00,11,11,0,104,13,91,97,92,5,13,59
Tue 29 Sep 2020 07:00,21,17,4,244,63,181,126,104,22,35,125
Tue 29 Sep 2020 08:00,40,34,6,357,88,269,203,188,15,44,201
Tue 29 Sep 2020 09:00,11,9,2,160,42,118,87,68,19,45,113
Tue 29 Sep 2020 10:00,13,8,5,87,28,59,60,43,17,39,46
Tue 29 Sep 2020 11:00,8,4,4,99,31,68,50,40,10,37,67
Tue 29 Sep 2020 12:00,17,12,5,154,54,100,77,53,24,56,56
Tue 29 Sep 2020 13:00,16,9,7,146,65,81,72,43,29,84,62
Tue 29 Sep 2020 14:00,19,9,10,159,69,90,72,41,31,80,45
Tue 29 Sep 2020 15:00,11,7,4,159,78,81,84,42,42,97,54
Tue 29 Sep 2020 16:00,26,14,12,238,130,108,109,55,54,161,78
Tue 29 Sep 2020 17:00,32,13,19,372,212,160,187,88,99,236,68
Tue 29 Sep 2020 18:00,26,8,18,300,175,125,145,47,98,202,72
Tue 29 Sep 2020 19:00,18,12,6,172,94,78,82,39,43,100,48
Tue 29 Sep 2020 20:00,2,1,1,139,82,57,67,36,31,66,36
Tue 29 Sep 2020 21:00,4,2,2,85,48,37,30,13,17,29,16
Tue 29 Sep 2020 22:00,2,1,1,49,34,15,30,21,9,27,15
Tue 29 Sep 2020 23:00,2,0,2,38,31,7,12,9,3,23,3
Wed 30 Sep 2020 00:00,0,0,0,14,9,5,2,1,1,7,5
Wed 30 Sep 2020 01:00,0,0,0,2,1,1,1,1,0,3,1
Wed 30 Sep 2020 02:00,0,0,0,1,1,0,0,0,0,3,3
Wed 30 Sep 2020 03:00,0,0,0,2,1,1,1,1,0,1,0
Wed 30 Sep 2020 04:00,1,1,0,12,5,7,2,1,1,0,3
Wed 30 Sep 2020 05:00,2,2,0,23,0,23,10,9,1,3,13
Wed 30 Sep 2020 06:00,8,8,0,78,13,65,71,66,5,10,50
Wed 30 Sep 2020 07:00,13,11,2,156,44,112,89,78,11,10,92
Wed 30 Sep 2020 08:00,26,19,7,239,54,185,128,115,13,20,100
Wed 30 Sep 2020 09:00,10,6,4,135,28,107,75,70,5,23,82
Wed 30 Sep 2020 10:00,4,2,2,76,21,55,27,23,4,24,42
Wed 30 Sep 2020 11:00,9,5,4,72,31,41,39,32,7,14,42
Wed 30 Sep 2020 12:00,6,4,2,109,47,62,50,33,17,46,37
Wed 30 Sep 2020 13:00,9,7,2,121,51,70,48,28,20,57,52
Wed 30 Sep 2020 14:00,10,5,5,101,44,57,57,32,25,54,19
Wed 30 Sep 2020 15:00,13,5,8,106,49,57,40,22,18,42,39
Wed 30 Sep 2020 16:00,10,3,7,139,75,64,50,21,29,96,34
Wed 30 Sep 2020 17:00,17,8,9,249,159,90,101,41,60,165,29
Wed 30 Sep 2020 18:00,13,7,6,198,109,89,84,29,55,132,33
Wed 30 Sep 2020 19:00,9,6,3,131,66,65,67,43,24,68,28
Wed 30 Sep 2020 20:00,5,2,3,99,60,39,23,12,11,50,25
Wed 30 Sep 2020 21:00,1,0,1,63,39,24,32,14,18,26,20
Wed 30 Sep 2020 22:00,2,1,1,48,32,16,8,2,6,23,6
Wed 30 Sep 2020 23:00,4,1,3,21,16,5,5,0,5,24,6
Thu 1 Oct 2020 00:00,1,0,1,8,4,4,4,2,2,8,9
Thu 1 Oct 2020 01:00,0,0,0,4,4,0,2,2,0,5,2
Thu 1 Oct 2020 02:00,0,0,0,1,0,1,2,0,2,2,2
Thu 1 Oct 2020 03:00,0,0,0,1,1,0,2,0,2,1,0
Thu 1 Oct 2020 04:00,0,0,0,8,3,5,1,1,0,1,7
Thu 1 Oct 2020 05:00,1,1,0,19,1,18,10,9,1,3,12
Thu 1 Oct 2020 06:00,5,5,0,90,13,77,85,79,6,11,61
Thu 1 Oct 2020 07:00,24,23,1,213,53,160,112,97,15,31,124
Thu 1 Oct 2020 08:00,28,23,5,312,69,243,173,146,27,47,217
Thu 1 Oct 2020 09:00,7,6,1,152,39,113,88,71,17,30,103
Thu 1 Oct 2020 10:00,8,5,3,121,40,81,45,35,10,41,63
Thu 1 Oct 2020 11:00,19,14,5,113,44,69,63,39,24,23,52
Thu 1 Oct 2020 12:00,10,7,3,157,58,99,69,47,22,72,68
Thu 1 Oct 2020 13:00,14,12,2,164,58,106,76,50,26,67,51
Thu 1 Oct 2020 14:00,22,13,9,159,73,86,60,34,26,70,30
Thu 1 Oct 2020 15:00,19,10,9,131,75,56,85,41,44,79,33
Thu 1 Oct 2020 16:00,21,11,10,193,99,94,80,33,47,135,47
Thu 1 Oct 2020 17:00,18,9,9,334,200,134,137,61,76,213,58
Thu 1 Oct 2020 18:00,20,11,9,207,112,95,106,54,52,159,35
Thu 1 Oct 2020 19:00,7,2,5,153,82,71,63,33,30,78,37
Thu 1 Oct 2020 20:00,11,5,6,118,77,41,36,13,23,58,26
Thu 1 Oct 2020 21:00,5,5,0,68,44,24,32,9,23,41,21
Thu 1 Oct 2020 22:00,5,1,4,42,27,15,15,3,12,32,11
Thu 1 Oct 2020 23:00,2,0,2,26,17,9,6,3,3,13,7
Fri 2 Oct 2020 00:00,1,1,0,11,5,6,2,0,2,4,3
Fri 2 Oct 2020 01:00,0,0,0,3,3,0,0,0,0,3,0
Fri 2 Oct 2020 02:00,0,0,0,0,0,0,0,0,0,2,0
Fri 2 Oct 2020 03:00,1,0,1,2,1,1,1,1,0,0,1
Fri 2 Oct 2020 04:00,1,0,1,7,4,3,3,2,1,1,4
Fri 2 Oct 2020 05:00,0,0,0,24,5,19,11,11,0,3,18
Fri 2 Oct 2020 06:00,6,6,0,88,11,77,72,69,3,13,53
Fri 2 Oct 2020 07:00,9,8,1,187,38,149,115,102,13,28,118
Fri 2 Oct 2020 08:00,33,28,5,285,69,216,145,124,21,51,193
Fri 2 Oct 2020 09:00,13,6,7,149,33,116,85,68,17,34,92
Fri 2 Oct 2020 10:00,9,9,0,123,40,83,41,28,13,21,50
Fri 2 Oct 2020 11:00,10,6,4,113,40,73,49,39,10,33,34
Fri 2 Oct 2020 12:00,19,12,7,155,53,102,72,49,23,59,55
Fri 2 Oct 2020 13:00,21,10,11,169,76,93,75,38,37,93,66
Fri 2 Oct 2020 14:00,15,7,8,170,77,93,83,45,38,95,46
Fri 2 Oct 2020 15:00,19,11,8,166,84,82,92,53,39,93,66
Fri 2 Oct 2020 16:00,19,10,9,177,99,78,99,44,55,131,59
Fri 2 Oct 2020 17:00,18,8,10,321,170,151,122,51,71,188,69
Fri 2 Oct 2020 18:00,20,9,11,246,135,111,116,63,53,148,59
Fri 2 Oct 2020 19:00,11,5,6,192,93,99,81,41,40,96,41
Fri 2 Oct 2020 20:00,8,3,5,139,75,64,62,36,26,68,34
Fri 2 Oct 2020 21:00,6,4,2,94,48,46,44,22,22,51,17
Fri 2 Oct 2020 22:00,3,2,1,59,45,14,34,13,21,43,13
Fri 2 Oct 2020 23:00,0,0,0,53,39,14,28,14,14,27,14
Sat 3 Oct 2020 00:00,0,0,0,35,23,12,10,7,3,16,4
Sat 3 Oct 2020 01:00,1,1,0,12,8,4,0,0,0,9,4
Sat 3 Oct 2020 02:00,2,1,1,5,2,3,2,2,0,3,3
Sat 3 Oct 2020 03:00,1,0,1,10,8,2,2,0,2,2,3
Sat 3 Oct 2020 04:00,1,1,0,5,3,2,1,1,0,3,7
Sat 3 Oct 2020 05:00,1,1,0,10,6,4,2,1,1,3,5
Sat 3 Oct 2020 06:00,1,1,0,33,5,28,19,17,2,7,19
Sat 3 Oct 2020 07:00,5,2,3,63,21,42,45,39,6,16,40
Sat 3 Oct 2020 08:00,5,5,0,80,36,44,30,26,4,27,34
Sat 3 Oct 2020 09:00,11,6,5,80,26,54,68,44,24,50,53
Sat 3 Oct 2020 10:00,10,8,2,104,33,71,86,56,30,40,46
Sat 3 Oct 2020 11:00,13,6,7,118,40,78,55,33,22,68,59
Sat 3 Oct 2020 12:00,13,8,5,149,52,97,68,39,29,62,72
Sat 3 Oct 2020 13:00,14,8,6,146,75,71,83,53,30,101,85
Sat 3 Oct 2020 14:00,13,7,6,131,52,79,68,38,30,79,69
Sat 3 Oct 2020 15:00,11,8,3,135,64,71,78,40,38,65,64
Sat 3 Oct 2020 16:00,8,3,5,125,33,92,61,40,21,57,51
Sat 3 Oct 2020 17:00,10,4,6,116,60,56,72,43,29,79,47
Sat 3 Oct 2020 18:00,15,10,5,135,77,58,56,37,19,86,36
Sat 3 Oct 2020 19:00,6,3,3,118,51,67,62,34,28,50,34
Sat 3 Oct 2020 20:00,6,3,3,92,49,43,54,34,20,57,39
Sat 3 Oct 2020 21:00,4,1,3,63,37,26,38,20,18,33,29
Sat 3 Oct 2020 22:00,4,2,2,45,26,19,25,13,12,32,9
Sat 3 Oct 2020 23:00,1,1,0,32,23,9,10,5,5,21,7
Sun 4 Oct 2020 00:00,4,1,3,24,17,7,8,3,5,10,6
Sun 4 Oct 2020 01:00,0,0,0,21,13,8,8,3,5,9,4
Sun 4 Oct 2020 02:00,0,0,0,13,11,2,2,1,1,7,1
Sun 4 Oct 2020 03:00,0,0,0,3,2,1,2,1,1,4,0
Sun 4 Oct 2020 04:00,0,0,0,5,2,3,0,0,0,3,3
Sun 4 Oct 2020 05:00,1,0,1,3,0,3,0,0,0,1,3
Sun 4 Oct 2020 06:00,1,1,0,17,6,11,11,10,1,5,10
Sun 4 Oct 2020 07:00,0,0,0,27,7,20,14,13,1,6,10
Sun 4 Oct 2020 08:00,2,1,1,27,5,22,13,5,8,12,7
Sun 4 Oct 2020 09:00,2,1,1,30,12,18,17,15,2,4,8
Sun 4 Oct 2020 10:00,1,1,0,23,8,15,11,10,1,6,12
Sun 4 Oct 2020 11:00,3,2,1,39,14,25,20,14,6,7,1
Sun 4 Oct 2020 12:00,4,2,2,56,23,33,22,16,6,14,12
Sun 4 Oct 2020 13:00,3,1,2,40,20,20,13,8,5,20,9
Sun 4 Oct 2020 14:00,5,2,3,61,27,34,22,16,6,17,11
Sun 4 Oct 2020 15:00,8,3,5,53,34,19,21,10,11,16,14
Sun 4 Oct 2020 16:00,4,3,1,42,19,23,23,12,11,19,21
Sun 4 Oct 2020 17:00,4,3,1,72,33,39,24,17,7,25,22
Sun 4 Oct 2020 18:00,5,4,1,75,35,40,43,29,14,36,24
Sun 4 Oct 2020 19:00,5,3,2,80,37,43,31,20,11,28,15
Sun 4 Oct 2020 20:00,2,1,1,55,26,29,36,18,18,34,16
Sun 4 Oct 2020 21:00,9,1,8,40,31,9,13,5,8,25,12
Sun 4 Oct 2020 22:00,4,0,4,29,21,8,11,4,7,16,5
Sun 4 Oct 2020 23:00,0,0,0,16,10,6,9,4,5,8,1
Mon 5 Oct 2020 00:00,1,0,1,4,1,3,1,0,1,1,0
Mon 5 Oct 2020 01:00,1,0,1,2,0,2,1,0,1,3,4
Mon 5 Oct 2020 02:00,0,0,0,3,2,1,0,0,0,3,0
Mon 5 Oct 2020 03:00,1,1,0,1,1,0,0,0,0,1,0
Mon 5 Oct 2020 04:00,0,0,0,6,2,4,1,1,0,2,3
Mon 5 Oct 2020 05:00,1,1,0,29,4,25,10,9,1,4,19
Mon 5 Oct 2020 06:00,5,5,0,73,15,58,68,59,9,15,53
Mon 5 Oct 2020 07:00,15,12,3,176,38,138,80,72,8,22,92
Mon 5 Oct 2020 08:00,24,17,7,246,61,185,127,117,10,41,179
Mon 5 Oct 2020 09:00,10,5,5,124,32,92,84,67,17,13,94
Mon 5 Oct 2020 10:00,4,2,2,71,17,54,39,33,6,26,33
Mon 5 Oct 2020 11:00,15,8,7,68,24,44,46,29,17,25,35
Mon 5 Oct 2020 12:00,6,3,3,102,38,64,45,30,15,44,44
Mon 5 Oct 2020 13:00,9,6,3,110,42,68,59,39,20,42,46
Mon 5 Oct 2020 14:00,13,6,7,99,43,56,53,31,22,68,24
Mon 5 Oct 2020 15:00,14,7,7,130,55,75,52,20,32,65,43
Mon 5 Oct 2020 16:00,12,4,8,155,88,67,79,35,44,137,36
Mon 5 Oct 2020 17:00,23,16,7,269,164,105,141,61,80,166,68
Mon 5 Oct 2020 18:00,10,3,7,224,129,95,106,36,70,154,45
Mon 5 Oct 2020 19:00,11,4,7,140,77,63,58,28,30,77,28
Mon 5 Oct 2020 20:00,8,3,5,107,54,53,47,27,20,47,24
Mon 5 Oct 2020 21:00,8,3,5,72,51,21,29,15,14,36,24
Mon 5 Oct 2020 22:00,4,2,2,38,20,18,17,8,9,30,4
Mon 5 Oct 2020 23:00,2,2,0,19,11,8,11,5,6,16,2
Tue 6 Oct 2020 00:00,0,0,0,13,7,6,5,3,2,1,2
Tue 6 Oct 2020 01:00,0,0,0,6,4,2,2,1,1,0,1
Tue 6 Oct 2020 02:00,0,0,0,2,2,0,0,0,0,2,2
Tue 6 Oct 2020 03:00,0,0,0,4,3,1,1,1,0,1,0
Tue 6 Oct 2020 04:00,0,0,0,8,2,6,0,0,0,2,3
Tue 6 Oct 2020 05:00,3,3,0,32,3,29,11,10,1,4,15
Tue 6 Oct 2020 06:00,7,6,1,98,16,82,76,70,6,15,67
Tue 6 Oct 2020 07:00,13,10,3,188,50,138,107,94,13,27,121
Tue 6 Oct 2020 08:00,22,16,6,259,59,200,148,143,5,36,156
Tue 6 Oct 2020 09:00,12,7,5,127,21,106,71,58,13,18,65
Tue 6 Oct 2020 10:00,3,2,1,75,27,48,25,21,4,13,39
Tue 6 Oct 2020 11:00,4,3,1,86,26,60,34,25,9,24,38
Tue 6 Oct 2020 12:00,4,2,2,99,43,56,60,33,27,36,38
Tue 6 Oct 2020 13:00,11,8,3,110,42,68,62,40,22,63,45
Tue 6 Oct 2020 14:00,11,6,5,100,53,47,53,30,23,61,40
Tue 6 Oct 2020 15:00,10,6,4,117,65,52,44,21,23,81,40
Tue 6 Oct 2020 16:00,20,12,8,178,102,76,78,34,44,131,50
Tue 6 Oct 2020 17:00,20,8,12,291,163,128,123,53,70,185,48
Tue 6 Oct 2020 18:00,12,5,7,254,145,109,112,53,59,152,45
Tue 6 Oct 2020 19:00,6,5,1,156,88,68,64,33,31,84,27
Tue 6 Oct 2020 20:00,1,0,1,114,61,53,43,18,25,65,24
Tue 6 Oct 2020 21:00,6,2,4,72,45,27,29,15,14,42,14
Tue 6 Oct 2020 22:00,3,3,0,47,29,18,25,19,6,27,15
Tue 6 Oct 2020 23:00,3,2,1,26,18,8,15,7,8,23,3
Wed 7 Oct 2020 00:00,0,0,0,11,8,3,1,0,1,5,3
Wed 7 Oct 2020 01:00,0,0,0,4,4,0,1,1,0,3,2
Wed 7 Oct 2020 02:00,0,0,0,3,1,2,0,0,0,1,1
Wed 7 Oct 2020 03:00,0,0,0,3,1,2,1,1,0,4,1
Wed 7 Oct 2020 04:00,0,0,0,7,3,4,1,1,0,0,2
Wed 7 Oct 2020 05:00,1,1,0,23,4,19,11,10,1,3,18
Wed 7 Oct 2020 06:00,5,5,0,104,16,88,84,73,11,9,68
Wed 7 Oct 2020 07:00,18,16,2,224,61,163,132,114,18,30,131
Wed 7 Oct 2020 08:00,41,34,7,320,67,253,176,165,11,49,179
Wed 7 Oct 2020 09:00,12,7,5,155,38,117,80,63,17,20,79
Wed 7 Oct 2020 10:00,9,8,1,71,21,50,48,35,13,23,42
Wed 7 Oct 2020 11:00,17,10,7,100,32,68,55,35,20,33,34
Wed 7 Oct 2020 12:00,19,10,9,135,54,81,63,40,23,63,48
Wed 7 Oct 2020 13:00,9,6,3,135,57,78,62,37,25,54,41
Wed 7 Oct 2020 14:00,17,7,10,125,51,74,60,35,25,82,48
Wed 7 Oct 2020 15:00,11,5,6,150,71,79,63,28,35,95,44
Wed 7 Oct 2020 16:00,17,8,9,180,101,79,87,34,53,153,61
Wed 7 Oct 2020 17:00,19,9,10,272,165,107,120,55,65,192,32
Wed 7 Oct 2020 18:00,20,11,9,236,133,103,82,35,47,156,44
Wed 7 Oct 2020 19:00,3,2,1,133,67,66,58,24,34,82,23
Wed 7 Oct 2020 20:00,4,2,2,99,57,42,33,17,16,48,23
Wed 7 Oct 2020 21:00,3,2,1,53,33,20,18,5,13,28,15
Wed 7 Oct 2020 22:00,1,1,0,40,28,12,11,4,7,29,8
Wed 7 Oct 2020 23:00,4,2,2,22,16,6,8,5,3,10,6
Thu 8 Oct 2020 00:00,0,0,0,8,2,6,1,1,0,2,1
Thu 8 Oct 2020 01:00,1,0,1,1,1,0,1,1,0,2,1
Thu 8 Oct 2020 02:00,0,0,0,3,2,1,2,2,0,2,1
Thu 8 Oct 2020 03:00,0,0,0,3,2,1,1,1,0,1,1
Thu 8 Oct 2020 04:00,0,0,0,6,0,6,0,0,0,1,2
Thu 8 Oct 2020 05:00,1,1,0,22,0,22,13,12,1,3,12
Thu 8 Oct 2020 06:00,3,3,0,94,14,80,84,78,6,12,73
Thu 8 Oct 2020 07:00,12,10,2,208,49,159,115,102,13,22,132
Thu 8 Oct 2020 08:00,29,25,4,299,75,224,174,160,14,45,174
Thu 8 Oct 2020 09:00,9,7,2,154,38,116,101,76,25,21,92
Thu 8 Oct 2020 10:00,12,8,4,100,36,64,39,30,9,16,37
Thu 8 Oct 2020 11:00,13,5,8,99,31,68,62,43,19,34,56
Thu 8 Oct 2020 12:00,6,4,2,135,58,77,57,34,23,57,60
Thu 8 Oct 2020 13:00,16,12,4,151,67,84,62,42,20,76,45
Thu 8 Oct 2020 14:00,18,9,9,129,54,75,65,38,27,66,37
Thu 8 Oct 2020 15:00,14,6,8,156,93,63,72,34,38,84,54
Thu 8 Oct 2020 16:00,25,12,13,201,109,92,107,49,58,136,62
Thu 8 Oct 2020 17:00,20,10,10,332,195,137,160,70,90,228,80
Thu 8 Oct 2020 18:00,15,8,7,274,154,120,125,53,72,178,66
Thu 8 Oct 2020 19:00,13,7,6,178,91,87,79,38,41,98,32
Thu 8 Oct 2020 20:00,10,5,5,116,64,52,50,23,27,54,18
Thu 8 Oct 2020 21:00,6,4,2,64,40,24,32,11,21,43,18
Thu 8 Oct 2020 22:00,6,4,2,64,39,25,21,9,12,31,11
Thu 8 Oct 2020 23:00,3,1,2,38,32,6,5,2,3,21,6
Fri 9 Oct 2020 00:00,1,0,1,12,6,6,7,2,5,12,3
Fri 9 Oct 2020 01:00,1,0,1,6,5,1,3,1,2,6,1
Fri 9 Oct 2020 02:00,0,0,0,6,3,3,0,0,0,4,1
Fri 9 Oct 2020 03:00,0,0,0,5,3,2,1,1,0,0,1
Fri 9 Oct 2020 04:00,0,0,0,14,7,7,3,2,1,3,6
Fri 9 Oct 2020 05:00,1,1,0,22,4,18,12,12,0,6,13
Fri 9 Oct 2020 06:00,4,4,0,97,15,82,83,77,6,10,64
Fri 9 Oct 2020 07:00,13,11,2,211,63,148,113,101,12,32,138
Fri 9 Oct 2020 08:00,28,20,8,289,71,218,139,127,12,37,175
Fri 9 Oct 2020 09:00,11,5,6,143,35,108,91,72,19,24,79
Fri 9 Oct 2020 10:00,9,4,5,95,31,64,53,39,14,23,40
Fri 9 Oct 2020 11:00,15,7,8,102,29,73,63,46,17,36,26
Fri 9 Oct 2020 12:00,22,15,7,157,61,96,63,38,25,53,53
Fri 9 Oct 2020 13:00,15,8,7,174,80,94,80,45,35,84,57
Fri 9 Oct 2020 14:00,22,13,9,151,60,91,83,39,44,74,49
Fri 9 Oct 2020 15:00,12,4,8,157,76,81,67,34,33,99,54
Fri 9 Oct 2020 16:00,11,5,6,206,105,101,94,45,49,113,44
Fri 9 Oct 2020 17:00,30,18,12,302,177,125,112,44,68,173,62
Fri 9 Oct 2020 18:00,8,3,5,276,133,143,110,58,52,157,56
Fri 9 Oct 2020 19:00,12,5,7,197,105,92,76,38,38,86,19
Fri 9 Oct 2020 20:00,6,2,4,120,68,52,46,24,22,54,27
Fri 9 Oct 2020 21:00,13,4,9,86,54,32,50,19,31,47,30
Fri 9 Oct 2020 22:00,6,5,1,56,37,19,26,10,16,28,17
Fri 9 Oct 2020 23:00,3,2,1,51,31,20,9,3,6,39,10
Sat 10 Oct 2020 00:00,1,0,1,26,15,11,13,7,6,18,6
Sat 10 Oct 2020 01:00,1,0,1,17,12,5,3,3,0,8,4
Sat 10 Oct 2020 02:00,1,1,0,16,7,9,2,2,0,6,2
Sat 10 Oct 2020 03:00,2,0,2,6,3,3,3,3,0,1,1
Sat 10 Oct 2020 04:00,0,0,0,7,4,3,1,1,0,4,2
Sat 10 Oct 2020 05:00,0,0,0,18,4,14,3,2,1,2,5
Sat 10 Oct 2020 06:00,0,0,0,38,4,34,18,15,3,4,21
Sat 10 Oct 2020 07:00,4,4,0,61,19,42,44,41,3,10,33
Sat 10 Oct 2020 08:00,7,6,1,60,19,41,37,28,9,17,31
Sat 10 Oct 2020 09:00,16,11,5,133,46,87,52,38,14,30,43
Sat 10 Oct 2020 10:00,10,6,4,126,37,89,76,48,28,49,37
Sat 10 Oct 2020 11:00,13,7,6,137,58,79,78,35,43,77,54
Sat 10 Oct 2020 12:00,18,12,6,172,70,102,78,44,34,87,62
Sat 10 Oct 2020 13:00,22,12,10,183,64,119,94,52,42,85,80
Sat 10 Oct 2020 14:00,22,10,12,158,63,95,104,59,45,100,77
Sat 10 Oct 2020 15:00,17,11,6,159,68,91,88,49,39,27,68
Sat 10 Oct 2020 16:00,15,11,4,126,53,73,77,46,31,87,89
Sat 10 Oct 2020 17:00,15,12,3,173,78,95,66,43,23,85,54
Sat 10 Oct 2020 18:00,12,8,4,152,83,69,95,65,30,80,58
Sat 10 Oct 2020 19:00,15,10,5,133,59,74,53,37,16,50,54
Sat 10 Oct 2020 20:00,10,6,4,93,48,45,48,26,22,63,27
Sat 10 Oct 2020 21:00,1,0,1,81,50,31,23,14,9,32,16
Sat 10 Oct 2020 22:00,3,2,1,52,29,23,30,13,17,33,14
Sat 10 Oct 2020 23:00,0,0,0,34,23,11,17,11,6,24,7
Sun 11 Oct 2020 00:00,0,0,0,27,16,11,6,4,2,6,8
Sun 11 Oct 2020 01:00,1,0,1,15,11,4,3,2,1,6,0
Sun 11 Oct 2020 02:00,1,0,1,7,5,2,5,3,2,9,3
Sun 11 Oct 2020 03:00,0,0,0,8,3,5,2,1,1,10,1
Sun 11 Oct 2020 04:00,0,0,0,7,1,6,2,2,0,2,2
Sun 11 Oct 2020 05:00,0,0,0,8,5,3,3,2,1,6,2
Sun 11 Oct 2020 06:00,1,1,0,19,4,15,15,14,1,7,11
Sun 11 Oct 2020 07:00,3,3,0,26,8,18,19,14,5,17,12
Sun 11 Oct 2020 08:00,4,2,2,66,24,42,26,19,7,36,13
Sun 11 Oct 2020 09:00,7,6,1,81,25,56,64,34,30,30,36
Sun 11 Oct 2020 10:00,10,5,5,113,38,75,67,31,36,44,52
Sun 11 Oct 2020 11:00,9,7,2,142,46,96,89,60,29,71,35
Sun 11 Oct 2020 12:00,13,6,7,194,64,130,130,82,48,71,53
Sun 11 Oct 2020 13:00,17,12,5,180,87,93,152,85,67,80,39
Sun 11 Oct 2020 14:00,33,15,18,154,54,100,166,93,73,104,69
Sun 11 Oct 2020 15:00,25,17,8,158,73,85,112,48,64,85,58
Sun 11 Oct 2020 16:00,20,13,7,130,64,66,83,31,52,89,73
Sun 11 Oct 2020 17:00,16,8,8,127,62,65,69,37,32,61,79
Sun 11 Oct 2020 18:00,18,4,14,146,76,70,77,35,42,56,45
Sun 11 Oct 2020 19:00,10,7,3,114,52,62,60,33,27,48,39
Sun 11 Oct 2020 20:00,8,1,7,83,45,38,43,16,27,51,23
Sun 11 Oct 2020 21:00,4,3,1,55,41,14,30,14,16,35,16
Sun 11 Oct 2020 22:00,2,0,2,39,27,12,32,7,25,24,3
Sun 11 Oct 2020 23:00,4,2,2,24,19,5,11,4,7,12,4
Mon 12 Oct 2020 00:00,2,0,2,10,8,2,3,3,0,7,3
Mon 12 Oct 2020 01:00,0,0,0,5,2,3,2,1,1,2,0
Mon 12 Oct 2020 02:00,0,0,0,2,2,0,1,1,0,4,1
Mon 12 Oct 2020 03:00,0,0,0,3,2,1,1,1,0,3,2
Mon 12 Oct 2020 04:00,0,0,0,6,3,3,0,0,0,2,4
Mon 12 Oct 2020 05:00,1,1,0,30,1,29,16,15,1,5,13
Mon 12 Oct 2020 06:00,6,6,0,80,11,69,81,73,8,15,59
Mon 12 Oct 2020 07:00,19,16,3,195,55,140,107,94,13,26,130
Mon 12 Oct 2020 08:00,24,19,5,285,65,220,166,145,21,42,157
Mon 12 Oct 2020 09:00,17,11,6,147,37,110,69,60,9,15,54
Mon 12 Oct 2020 10:00,7,3,4,76,23,53,40,32,8,25,40
Mon 12 Oct 2020 11:00,9,5,4,63,21,42,42,32,10,35,34
Mon 12 Oct 2020 12:00,13,4,9,122,52,70,54,31,23,62,37
Mon 12 Oct 2020 13:00,11,5,6,122,42,80,58,37,21,53,57
Mon 12 Oct 2020 14:00,15,10,5,102,50,52,58,34,24,71,43
Mon 12 Oct 2020 15:00,13,8,5,103,47,56,63,24,39,80,50
Mon 12 Oct 2020 16:00,23,13,10,165,102,63,80,34,46,118,42
Mon 12 Oct 2020 17:00,17,8,9,282,166,116,158,64,94,193,61
Mon 12 Oct 2020 18:00,24,14,10,213,109,104,94,40,54,142,19
Mon 12 Oct 2020 19:00,10,2,8,140,79,61,66,26,40,102,26
Mon 12 Oct 2020 20:00,4,1,3,119,69,50,35,17,18,51,24
Mon 12 Oct 2020 21:00,13,6,7,57,41,16,42,12,30,34,15
Mon 12 Oct 2020 22:00,1,0,1,33,20,13,30,14,16,21,5
Mon 12 Oct 2020 23:00,0,0,0,17,11,6,7,2,5,12,5
Tue 13 Oct 2020 00:00,2,0,2,10,6,4,4,2,2,2,3
Tue 13 Oct 2020 01:00,0,0,0,3,1,2,2,1,1,0,0
Tue 13 Oct 2020 02:00,0,0,0,4,2,2,0,0,0,1,0
Tue 13 Oct 2020 03:00,0,0,0,3,1,2,1,1,0,0,0
Tue 13 Oct 2020 04:00,1,0,1,8,3,5,0,0,0,0,3
Tue 13 Oct 2020 05:00,1,1,0,31,2,29,13,12,1,4,11
Tue 13 Oct 2020 06:00,5,5,0,98,12,86,89,81,8,13,68
Tue 13 Oct 2020 07:00,20,16,4,209,62,147,127,106,21,35,132
Tue 13 Oct 2020 08:00,33,29,4,351,82,269,178,165,13,39,212
Tue 13 Oct 2020 09:00,20,13,7,178,31,147,100,78,22,34,82
Tue 13 Oct 2020 10:00,14,8,6,76,32,44,43,31,12,27,62
Tue 13 Oct 2020 11:00,8,3,5,85,29,56,55,37,18,31,40
Tue 13 Oct 2020 12:00,11,8,3,134,54,80,77,40,37,61,45
Tue 13 Oct 2020 13:00,6,2,4,131,64,67,105,67,38,71,61
Tue 13 Oct 2020 14:00,16,11,5,127,61,66,94,57,37,64,38
Tue 13 Oct 2020 15:00,16,9,7,141,76,65,93,43,50,102,38
Tue 13 Oct 2020 16:00,20,8,12,189,111,78,154,65,89,163,52
Tue 13 Oct 2020 17:00,29,16,13,315,196,119,197,82,115,185,58
Tue 13 Oct 2020 18:00,16,8,8,243,155,88,116,47,69,175,31
Tue 13 Oct 2020 19:00,1,1,0,156,81,75,78,38,40,57,26
Tue 13 Oct 2020 20:00,7,1,6,97,52,45,36,14,22,56,22
Tue 13 Oct 2020 21:00,7,3,4,53,32,21,25,8,17,28,11
Tue 13 Oct 2020 22:00,0,0,0,41,32,9,29,16,13,26,11
Tue 13 Oct 2020 23:00,1,0,1,25,17,8,12,4,8,20,7
Wed 14 Oct 2020 00:00,1,0,1,12,6,6,9,4,5,2,1
Wed 14 Oct 2020 01:00,1,0,1,9,5,4,2,2,0,1,3
Wed 14 Oct 2020 02:00,0,0,0,0,0,0,0,0,0,0,0
Wed 14 Oct 2020 03:00,0,0,0,2,2,0,1,1,0,0,0
Wed 14 Oct 2020 04:00,0,0,0,9,3,6,0,0,0,0,2
Wed 14 Oct 2020 05:00,2,2,0,29,2,27,15,14,1,5,15
Wed 14 Oct 2020 06:00,8,8,0,115,26,89,89,82,7,14,67
Wed 14 Oct 2020 07:00,18,14,4,213,59,154,120,101,19,27,128
Wed 14 Oct 2020 08:00,33,25,8,328,75,253,169,155,14,37,142
Wed 14 Oct 2020 09:00,7,3,4,168,30,138,75,62,13,16,55
Wed 14 Oct 2020 10:00,9,7,2,78,27,51,34,27,7,20,51
Wed 14 Oct 2020 11:00,11,6,5,84,25,59,40,28,12,32,42
Wed 14 Oct 2020 12:00,14,11,3,127,59,68,75,45,30,64,54
Wed 14 Oct 2020 13:00,9,7,2,152,67,85,61,43,18,63,48
Wed 14 Oct 2020 14:00,14,7,7,136,65,71,78,50,28,68,55
Wed 14 Oct 2020 15:00,24,13,11,153,73,80,81,41,40,93,49
Wed 14 Oct 2020 16:00,13,3,10,182,95,87,115,50,65,128,43
Wed 14 Oct 2020 17:00,29,13,16,333,219,114,151,61,90,207,56
Wed 14 Oct 2020 18:00,15,3,12,240,130,110,123,49,74,162,56
Wed 14 Oct 2020 19:00,4,1,3,176,94,82,67,34,33,100,39
Wed 14 Oct 2020 20:00,15,8,7,131,72,59,40,20,20,67,31
Wed 14 Oct 2020 21:00,7,3,4,76,44,32,36,16,20,32,23
Wed 14 Oct 2020 22:00,3,1,2,50,31,19,14,5,9,39,19
Wed 14 Oct 2020 23:00,1,1,0,28,19,9,10,6,4,17,7
Thu 15 Oct 2020 00:00,1,1,0,22,11,11,1,1,0,12,1
Thu 15 Oct 2020 01:00,0,0,0,5,3,2,2,1,1,2,1
Thu 15 Oct 2020 02:00,0,0,0,2,2,0,0,0,0,6,0
Thu 15 Oct 2020 03:00,0,0,0,4,3,1,1,1,0,3,0
Thu 15 Oct 2020 04:00,0,0,0,5,0,5,0,0,0,2,3
Thu 15 Oct 2020 05:00,2,2,0,25,3,22,13,12,1,3,11
Thu 15 Oct 2020 06:00,10,8,2,97,12,85,85,75,10,16,65
Thu 15 Oct 2020 07:00,16,14,2,204,44,160,132,111,21,23,78
Thu 15 Oct 2020 08:00,24,20,4,285,71,214,149,135,14,38,156
Thu 15 Oct 2020 09:00,5,4,1,137,29,108,63,47,16,10,59
Thu 15 Oct 2020 10:00,5,5,0,79,19,60,60,54,6,13,27
Thu 15 Oct 2020 11:00,5,3,2,89,28,61,48,37,11,26,50
Thu 15 Oct 2020 12:00,11,6,5,119,46,73,51,38,13,49,43
Thu 15 Oct 2020 13:00,18,10,8,160,68,92,65,41,24,70,56
Thu 15 Oct 2020 14:00,18,10,8,141,64,77,90,42,48,73,53
Thu 15 Oct 2020 15:00,10,7,3,158,77,81,60,28,32,75,50
Thu 15 Oct 2020 16:00,13,9,4,181,106,75,109,43,66,143,40
Thu 15 Oct 2020 17:00,25,12,13,274,160,114,148,60,88,177,64
Thu 15 Oct 2020 18:00,25,15,10,238,145,93,130,55,75,186,33
Thu 15 Oct 2020 19:00,8,6,2,181,84,97,76,40,36,103,48
Thu 15 Oct 2020 20:00,2,0,2,91,50,41,43,18,25,77,24
Thu 15 Oct 2020 21:00,2,1,1,57,39,18,36,15,21,48,11
Thu 15 Oct 2020 22:00,4,3,1,74,44,30,32,17,15,27,11
Thu 15 Oct 2020 23:00,1,1,0,32,23,9,10,4,6,24,8
Fri 16 Oct 2020 00:00,1,1,0,15,11,4,5,2,3,16,2
Fri 16 Oct 2020 01:00,0,0,0,5,3,2,3,2,1,3,1
Fri 16 Oct 2020 02:00,0,0,0,2,2,0,0,0,0,3,3
Fri 16 Oct 2020 03:00,0,0,0,2,1,1,1,1,0,4,1
Fri 16 Oct 2020 04:00,0,0,0,7,5,2,3,2,1,2,3
Fri 16 Oct 2020 05:00,2,2,0,23,2,21,16,16,0,4,16
Fri 16 Oct 2020 06:00,6,6,0,102,18,84,83,80,3,9,55
Fri 16 Oct 2020 07:00,10,7,3,192,51,141,126,107,19,31,143
Fri 16 Oct 2020 08:00,33,24,9,283,86,197,153,132,21,43,153
Fri 16 Oct 2020 09:00,13,7,6,149,30,119,117,99,18,31,97
Fri 16 Oct 2020 10:00,14,10,4,89,28,61,58,34,24,30,51
Fri 16 Oct 2020 11:00,17,10,7,91,30,61,56,38,18,30,43
Fri 16 Oct 2020 12:00,14,5,9,147,58,89,63,44,19,48,50
Fri 16 Oct 2020 13:00,12,9,3,125,53,72,79,46,33,82,59
Fri 16 Oct 2020 14:00,14,6,8,166,81,85,93,50,43,77,53
Fri 16 Oct 2020 15:00,16,6,10,166,81,85,86,39,47,92,39
Fri 16 Oct 2020 16:00,11,8,3,198,103,95,89,37,52,111,58
Fri 16 Oct 2020 17:00,27,11,16,285,153,132,143,59,84,199,69
Fri 16 Oct 2020 18:00,20,9,11,215,123,92,112,51,61,177,38
Fri 16 Oct 2020 19:00,6,1,5,177,89,88,84,50,34,88,46
Fri 16 Oct 2020 20:00,13,10,3,129,73,56,50,29,21,59,32
Fri 16 Oct 2020 21:00,6,2,4,89,48,41,43,27,16,62,24
Fri 16 Oct 2020 22:00,3,0,3,65,49,16,32,12,20,38,12
Fri 16 Oct 2020 23:00,7,4,3,41,26,15,13,7,6,25,7
Sat 17 Oct 2020 00:00,1,1,0,32,21,11,10,6,4,19,5
Sat 17 Oct 2020 01:00,0,0,0,18,13,5,9,5,4,6,1
Sat 17 Oct 2020 02:00,2,2,0,8,7,1,3,1,2,5,2
Sat 17 Oct 2020 03:00,0,0,0,6,1,5,0,0,0,4,3
Sat 17 Oct 2020 04:00,0,0,0,8,3,5,2,1,1,3,2
Sat 17 Oct 2020 05:00,0,0,0,11,3,8,1,1,0,2,3
Sat 17 Oct 2020 06:00,1,1,0,34,6,28,22,21,1,9,24
Sat 17 Oct 2020 07:00,4,2,2,55,8,47,47,42,5,12,37
Sat 17 Oct 2020 08:00,2,1,1,72,25,47,35,29,6,20,23
Sat 17 Oct 2020 09:00,8,5,3,108,40,68,61,40,21,33,39
Sat 17 Oct 2020 10:00,18,15,3,116,48,68,73,45,28,55,60
Sat 17 Oct 2020 11:00,23,12,11,111,37,74,91,69,22,61,50
Sat 17 Oct 2020 12:00,23,11,12,164,70,94,119,73,46,83,67
Sat 17 Oct 2020 13:00,20,10,10,150,61,89,108,66,42,92,39
Sat 17 Oct 2020 14:00,21,17,4,170,73,97,87,43,44,83,37
Sat 17 Oct 2020 15:00,17,3,14,129,61,68,81,33,48,78,56
Sat 17 Oct 2020 16:00,11,5,6,138,72,66,82,50,32,75,59
Sat 17 Oct 2020 17:00,8,2,6,134,55,79,72,40,32,76,52
Sat 17 Oct 2020 18:00,14,10,4,147,67,80,51,28,23,96,44
Sat 17 Oct 2020 19:00,15,7,8,132,70,62,51,25,26,56,38
Sat 17 Oct 2020 20:00,6,5,1,88,48,40,59,38,21,55,39
Sat 17 Oct 2020 21:00,5,1,4,67,37,30,27,15,12,46,22
Sat 17 Oct 2020 22:00,4,1,3,38,28,10,25,12,13,30,9
Sat 17 Oct 2020 23:00,6,5,1,48,34,14,14,5,9,21,8
Sun 18 Oct 2020 00:00,3,1,2,28,19,9,7,6,1,16,4
Sun 18 Oct 2020 01:00,2,1,1,8,4,4,7,2,5,16,2
Sun 18 Oct 2020 02:00,1,1,0,8,5,3,7,4,3,4,0
Sun 18 Oct 2020 03:00,0,0,0,4,2,2,3,0,3,5,1
Sun 18 Oct 2020 04:00,1,1,0,5,3,2,1,1,0,5,3
Sun 18 Oct 2020 05:00,0,0,0,7,3,4,1,1,0,2,3
Sun 18 Oct 2020 06:00,0,0,0,28,8,20,10,10,0,15,13
Sun 18 Oct 2020 07:00,5,5,0,42,18,24,27,23,4,9,30
Sun 18 Oct 2020 08:00,22,3,19,50,14,36,58,22,36,31,32
Sun 18 Oct 2020 09:00,10,7,3,72,22,50,73,34,39,50,35
Sun 18 Oct 2020 10:00,12,7,5,113,42,71,74,47,27,62,43
Sun 18 Oct 2020 11:00,26,16,10,150,39,111,99,61,38,75,50
Sun 18 Oct 2020 12:00,26,18,8,188,76,112,116,86,30,75,69
Sun 18 Oct 2020 13:00,26,14,12,181,79,102,110,68,42,96,69
Sun 18 Oct 2020 14:00,23,8,15,160,67,93,113,56,57,62,79
Sun 18 Oct 2020 15:00,18,14,4,161,62,99,113,72,41,93,72
Sun 18 Oct 2020 16:00,15,10,5,150,74,76,84,44,40,61,78
Sun 18 Oct 2020 17:00,11,5,6,137,66,71,84,45,39,85,42
Sun 18 Oct 2020 18:00,15,7,8,132,82,50,57,30,27,72,27
Sun 18 Oct 2020 19:00,10,4,6,98,61,37,59,40,19,59,25
Sun 18 Oct 2020 20:00,5,5,0,75,36,39,35,24,11,40,16
Sun 18 Oct 2020 21:00,7,4,3,70,48,22,16,10,6,33,3
Sun 18 Oct 2020 22:00,4,3,1,33,23,10,24,11,13,24,11
Sun 18 Oct 2020 23:00,0,0,0,17,16,1,11,8,3,12,4
Mon 19 Oct 2020 00:00,1,1,0,14,9,5,1,1,0,5,0
Mon 19 Oct 2020 01:00,1,0,1,1,1,0,1,0,1,1,0
Mon 19 Oct 2020 02:00,1,0,1,2,0,2,0,0,0,1,2
Mon 19 Oct 2020 03:00,0,0,0,3,1,2,3,1,2,4,2
Mon 19 Oct 2020 04:00,0,0,0,10,4,6,2,1,1,1,1
Mon 19 Oct 2020 05:00,2,2,0,25,2,23,18,18,0,5,19
Mon 19 Oct 2020 06:00,7,6,1,81,9,72,75,68,7,9,57
Mon 19 Oct 2020 07:00,9,7,2,183,50,133,94,83,11,27,109
Mon 19 Oct 2020 08:00,24,20,4,280,66,214,142,126,16,46,113
Mon 19 Oct 2020 09:00,13,7,6,134,26,108,63,56,7,22,65
Mon 19 Oct 2020 10:00,2,1,1,63,19,44,37,27,10,10,21
Mon 19 Oct 2020 11:00,4,2,2,81,25,56,40,27,13,20,28
Mon 19 Oct 2020 12:00,6,5,1,96,42,54,36,23,13,31,28
Mon 19 Oct 2020 13:00,10,8,2,95,41,54,45,30,15,34,18
Mon 19 Oct 2020 14:00,6,3,3,86,34,52,44,28,16,46,19
Mon 19 Oct 2020 15:00,5,1,4,88,55,33,49,22,27,53,36
Mon 19 Oct 2020 16:00,16,8,8,167,92,75,68,31,37,81,27
Mon 19 Oct 2020 17:00,17,7,10,239,152,87,115,49,66,146,33
Mon 19 Oct 2020 18:00,15,6,9,184,113,71,75,32,43,136,14
Mon 19 Oct 2020 19:00,8,2,6,105,62,43,48,24,24,70,21
Mon 19 Oct 2020 20:00,7,4,3,79,47,32,35,17,18,51,16
Mon 19 Oct 2020 21:00,5,1,4,46,29,17,28,14,14,28,12
Mon 19 Oct 2020 22:00,0,0,0,30,22,8,20,6,14,17,1
Mon 19 Oct 2020 23:00,1,1,0,17,14,3,8,5,3,7,1
Tue 20 Oct 2020 00:00,0,0,0,6,2,4,4,3,1,6,3
Tue 20 Oct 2020 01:00,0,0,0,2,2,0,2,2,0,3,0
Tue 20 Oct 2020 02:00,0,0,0,0,0,0,0,0,0,1,4
Tue 20 Oct 2020 03:00,0,0,0,2,1,1,0,0,0,1,1
Tue 20 Oct 2020 04:00,0,0,0,9,3,6,4,3,1,1,2
Tue 20 Oct 2020 05:00,2,1,1,32,4,28,12,12,0,4,14
Tue 20 Oct 2020 06:00,6,6,0,78,8,70,73,70,3,15,59
Tue 20 Oct 2020 07:00,12,9,3,189,43,146,102,88,14,33,88
Tue 20 Oct 2020 08:00,32,22,10,290,74,216,143,129,14,34,145
Tue 20 Oct 2020 09:00,12,8,4,125,23,102,48,37,11,18,44
Tue 20 Oct 2020 10:00,5,5,0,51,16,35,30,28,2,10,37
Tue 20 Oct 2020 11:00,10,8,2,71,17,54,31,22,9,19,29
Tue 20 Oct 2020 12:00,9,6,3,85,34,51,54,35,19,49,45
Tue 20 Oct 2020 13:00,14,9,5,115,51,64,49,36,13,36,30
Tue 20 Oct 2020 14:00,9,4,5,87,39,48,62,33,29,58,32
Tue 20 Oct 2020 15:00,16,10,6,134,73,61,61,32,29,80,47
Tue 20 Oct 2020 16:00,26,13,13,117,99,18,56,27,29,110,33
Tue 20 Oct 2020 17:00,17,10,7,223,160,63,131,57,74,164,56
Tue 20 Oct 2020 18:00,15,7,8,216,122,94,100,40,60,133,23
Tue 20 Oct 2020 19:00,11,6,5,181,95,86,52,21,31,67,25
Tue 20 Oct 2020 20:00,5,3,2,96,52,44,37,15,22,45,30
Tue 20 Oct 2020 21:00,5,2,3,57,34,23,43,21,22,40,20
Tue 20 Oct 2020 22:00,4,0,4,67,40,27,19,15,4,25,9
Tue 20 Oct 2020 23:00,0,0,0,31,26,5,10,5,5,10,3
Wed 21 Oct 2020 00:00,1,1,0,10,6,4,2,2,0,9,3
Wed 21 Oct 2020 01:00,0,0,0,8,6,2,2,2,0,5,2
Wed 21 Oct 2020 02:00,0,0,0,0,0,0,1,0,1,4,1
Wed 21 Oct 2020 03:00,0,0,0,3,1,2,2,2,0,3,1
Wed 21 Oct 2020 04:00,0,0,0,8,3,5,1,0,1,1,6
Wed 21 Oct 2020 05:00,1,1,0,24,3,21,20,19,1,1,18
Wed 21 Oct 2020 06:00,4,4,0,95,13,82,87,83,4,13,79
Wed 21 Oct 2020 07:00,10,9,1,209,52,157,114,96,18,34,125
Wed 21 Oct 2020 08:00,30,21,9,303,68,235,152,139,13,34,141
Wed 21 Oct 2020 09:00,16,10,6,162,36,126,103,83,20,25,91
Wed 21 Oct 2020 10:00,8,2,6,96,34,62,56,36,20,28,56
Wed 21 Oct 2020 11:00,11,8,3,93,30,63,50,31,19,39,61
Wed 21 Oct 2020 12:00,17,10,7,139,44,95,57,41,16,54,60
Wed 21 Oct 2020 13:00,9,9,0,162,64,98,73,48,25,78,62
Wed 21 Oct 2020 14:00,21,10,11,129,59,70,69,43,26,70,27
Wed 21 Oct 2020 15:00,14,10,4,159,75,84,71,34,37,85,53
Wed 21 Oct 2020 16:00,20,13,7,186,102,84,102,44,58,151,51
Wed 21 Oct 2020 17:00,27,16,11,280,168,112,143,61,82,204,78
Wed 21 Oct 2020 18:00,16,3,13,280,157,123,114,54,60,164,60
Wed 21 Oct 2020 19:00,18,10,8,169,76,93,75,37,38,79,38
Wed 21 Oct 2020 20:00,7,4,3,147,67,80,52,27,25,68,23
Wed 21 Oct 2020 21:00,6,1,5,49,25,24,40,21,19,49,19
Wed 21 Oct 2020 22:00,1,1,0,35,22,13,22,8,14,28,8
Wed 21 Oct 2020 23:00,5,1,4,48,38,10,14,7,7,19,5
Thu 22 Oct 2020 00:00,1,0,1,10,7,3,6,2,4,9,3
Thu 22 Oct 2020 01:00,1,1,0,5,4,1,3,1,2,5,4
Thu 22 Oct 2020 02:00,0,0,0,4,3,1,0,0,0,1,3
Thu 22 Oct 2020 03:00,0,0,0,4,1,3,2,1,1,2,0
Thu 22 Oct 2020 04:00,0,0,0,6,1,5,1,0,1,2,1
Thu 22 Oct 2020 05:00,1,1,0,25,1,24,9,7,2,3,11
Thu 22 Oct 2020 06:00,3,3,0,88,11,77,85,76,9,13,61
Thu 22 Oct 2020 07:00,13,12,1,192,53,139,99,87,12,36,104
Thu 22 Oct 2020 08:00,24,19,5,285,87,198,131,118,13,42,147
Thu 22 Oct 2020 09:00,12,8,4,107,26,81,85,70,15,19,59
Thu 22 Oct 2020 10:00,4,2,2,80,26,54,28,20,8,20,38
Thu 22 Oct 2020 11:00,11,7,4,126,39,87,50,35,15,37,42
Thu 22 Oct 2020 12:00,8,3,5,114,47,67,66,33,33,55,46
Thu 22 Oct 2020 13:00,8,5,3,131,59,72,67,40,27,45,42
Thu 22 Oct 2020 14:00,16,6,10,121,54,67,71,40,31,57,38
Thu 22 Oct 2020 15:00,13,7,6,135,67,68,94,45,49,76,37
Thu 22 Oct 2020 16:00,27,14,13,177,104,73,109,43,66,105,47
Thu 22 Oct 2020 17:00,23,12,11,253,146,107,141,72,69,174,53
Thu 22 Oct 2020 18:00,19,6,13,220,136,84,122,51,71,170,51
Thu 22 Oct 2020 19:00,7,5,2,147,77,70,74,33,41,91,26
Thu 22 Oct 2020 20:00,5,2,3,92,55,37,31,15,16,34,7
Thu 22 Oct 2020 21:00,2,0,2,46,36,10,36,12,24,31,11
Thu 22 Oct 2020 22:00,2,1,1,36,23,13,14,9,5,26,3
Thu 22 Oct 2020 23:00,0,0,0,21,15,6,4,1,3,12,4
Fri 23 Oct 2020 00:00,1,0,1,10,7,3,4,3,1,5,0
Fri 23 Oct 2020 01:00,0,0,0,1,0,1,3,1,2,2,1
Fri 23 Oct 2020 02:00,1,0,1,0,0,0,1,1,0,2,1
Fri 23 Oct 2020 03:00,0,0,0,2,1,1,1,1,0,2,0
Fri 23 Oct 2020 04:00,0,0,0,10,5,5,1,0,1,1,4
Fri 23 Oct 2020 05:00,1,1,0,23,5,18,9,8,1,3,9
Fri 23 Oct 2020 06:00,2,2,0,83,13,70,67,61,6,12,59
Fri 23 Oct 2020 07:00,7,7,0,141,39,102,87,70,17,26,91
Fri 23 Oct 2020 08:00,19,15,4,232,70,162,118,109,9,33,116
Fri 23 Oct 2020 09:00,16,10,6,120,30,90,78,61,17,20,57
Fri 23 Oct 2020 10:00,7,4,3,82,25,57,53,36,17,13,40
Fri 23 Oct 2020 11:00,12,7,5,90,29,61,69,48,21,29,29
Fri 23 Oct 2020 12:00,17,8,9,118,56,62,66,44,22,41,39
Fri 23 Oct 2020 13:00,14,8,6,144,56,88,74,44,30,54,27
Fri 23 Oct 2020 14:00,8,4,4,149,80,69,74,34,40,82,41
Fri 23 Oct 2020 15:00,16,9,7,158,82,76,80,39,41,71,39
Fri 23 Oct 2020 16:00,25,11,14,185,95,90,90,43,47,103,50
Fri 23 Oct 2020 17:00,10,6,4,216,116,100,91,37,54,141,23
Fri 23 Oct 2020 18:00,17,8,9,209,120,89,119,64,55,121,50
Fri 23 Oct 2020 19:00,14,5,9,158,85,73,73,43,30,69,35
Fri 23 Oct 2020 20:00,8,6,2,105,48,57,62,29,33,55,33
Fri 23 Oct 2020 21:00,3,2,1,64,41,23,49,19,30,42,25
Fri 23 Oct 2020 22:00,3,3,0,51,31,20,21,12,9,29,13
Fri 23 Oct 2020 23:00,1,0,1,30,23,7,14,4,10,11,8
Sat 24 Oct 2020 00:00,0,0,0,19,8,11,3,1,2,9,3
Sat 24 Oct 2020 01:00,0,0,0,10,7,3,3,3,0,2,3
Sat 24 Oct 2020 02:00,0,0,0,3,3,0,0,0,0,1,5
Sat 24 Oct 2020 03:00,0,0,0,6,3,3,0,0,0,0,0
Sat 24 Oct 2020 04:00,0,0,0,4,1,3,0,0,0,0,5
Sat 24 Oct 2020 05:00,1,1,0,11,4,7,4,3,1,2,4
Sat 24 Oct 2020 06:00,1,1,0,26,3,23,10,8,2,10,16
Sat 24 Oct 2020 07:00,2,1,1,33,5,28,18,15,3,7,19
Sat 24 Oct 2020 08:00,2,2,0,42,19,23,20,15,5,12,20
Sat 24 Oct 2020 09:00,6,6,0,52,23,29,18,13,5,19,12
Sat 24 Oct 2020 10:00,9,2,7,55,15,40,33,22,11,14,25
Sat 24 Oct 2020 11:00,13,8,5,99,43,56,47,29,18,44,49
Sat 24 Oct 2020 12:00,10,5,5,117,52,65,65,40,25,58,35
Sat 24 Oct 2020 13:00,31,19,12,116,48,68,112,74,38,64,46
Sat 24 Oct 2020 14:00,14,6,8,140,57,83,81,55,26,65,55
Sat 24 Oct 2020 15:00,15,13,2,138,54,84,82,47,35,70,40
Sat 24 Oct 2020 16:00,15,12,3,122,53,69,74,39,35,53,36
Sat 24 Oct 2020 17:00,9,7,2,129,70,59,58,35,23,44,35
Sat 24 Oct 2020 18:00,7,1,6,134,77,57,60,35,25,59,21
Sat 24 Oct 2020 19:00,6,4,2,104,60,44,62,41,21,52,18
Sat 24 Oct 2020 20:00,14,13,1,98,56,42,58,33,25,40,27
Sat 24 Oct 2020 21:00,3,2,1,53,33,20,27,13,14,41,12
Sat 24 Oct 2020 22:00,2,2,0,51,35,16,22,11,11,19,5
Sat 24 Oct 2020 23:00,5,4,1,34,25,9,23,14,9,17,8
Sun 25 Oct 2020 00:00,0,0,0,14,8,6,4,2,2,9,5
Sun 25 Oct 2020 01:00,0,0,0,8,6,2,5,5,0,4,2
Sun 25 Oct 2020 02:00,0,0,0,3,1,2,3,0,3,2,2
Sun 25 Oct 2020 03:00,0,0,0,2,2,0,2,2,0,1,4
Sun 25 Oct 2020 04:00,0,0,0,5,3,2,1,1,0,1,1
Sun 25 Oct 2020 05:00,0,0,0,3,1,2,3,2,1,2,2
Sun 25 Oct 2020 06:00,1,1,0,24,2,22,7,7,0,8,10
Sun 25 Oct 2020 07:00,1,1,0,35,8,27,24,21,3,9,13
Sun 25 Oct 2020 08:00,6,3,3,62,31,31,29,21,8,30,11
Sun 25 Oct 2020 09:00,18,9,9,119,52,67,56,40,16,24,16
Sun 25 Oct 2020 10:00,16,11,5,147,59,88,70,47,23,46,45
Sun 25 Oct 2020 11:00,12,6,6,180,60,120,113,65,48,62,51
Sun 25 Oct 2020 12:00,27,13,14,206,84,122,138,81,57,62,65
Sun 25 Oct 2020 13:00,26,8,18,195,83,112,138,74,64,82,64
Sun 25 Oct 2020 14:00,29,18,11,184,83,101,144,76,68,99,83
Sun 25 Oct 2020 15:00,29,15,14,171,83,88,131,58,73,83,79
Sun 25 Oct 2020 16:00,20,7,13,165,96,69,102,45,57,72,85
Sun 25 Oct 2020 17:00,12,11,1,147,83,64,78,34,44,73,46
Sun 25 Oct 2020 18:00,8,2,6,119,60,59,68,39,29,48,16
Sun 25 Oct 2020 19:00,5,5,0,82,44,38,60,39,21,53,21
Sun 25 Oct 2020 20:00,4,0,4,57,30,27,28,16,12,31,25
Sun 25 Oct 2020 21:00,1,0,1,54,34,20,35,26,9,35,15
Sun 25 Oct 2020 22:00,0,0,0,26,19,7,13,9,4,15,5
Sun 25 Oct 2020 23:00,2,2,0,23,18,5,10,6,4,10,4
Mon 26 Oct 2020 00:00,0,0,0,7,4,3,4,2,2,4,4
Mon 26 Oct 2020 01:00,0,0,0,6,4,2,2,1,1,3,3
Mon 26 Oct 2020 02:00,0,0,0,3,1,2,2,1,1,3,1
Mon 26 Oct 2020 03:00,0,0,0,4,3,1,1,0,1,1,1
Mon 26 Oct 2020 04:00,0,0,0,0,0,0,0,0,0,0,0
Mon 26 Oct 2020 05:00,0,0,0,8,2,6,2,2,0,1,5
Mon 26 Oct 2020 06:00,2,2,0,19,4,15,15,12,3,15,9
Mon 26 Oct 2020 07:00,3,2,1,33,12,21,25,23,2,10,17
Mon 26 Oct 2020 08:00,0,0,0,58,21,37,28,23,5,18,27
Mon 26 Oct 2020 09:00,16,11,5,77,22,55,36,27,9,24,17
Mon 26 Oct 2020 10:00,25,17,8,98,35,63,88,69,19,35,32
Mon 26 Oct 2020 11:00,10,7,3,125,48,77,81,56,25,45,42
Mon 26 Oct 2020 12:00,11,6,5,128,58,70,71,46,25,71,55
Mon 26 Oct 2020 13:00,18,9,9,120,48,72,96,58,38,88,55
Mon 26 Oct 2020 14:00,16,8,8,145,67,78,103,49,54,71,50
Mon 26 Oct 2020 15:00,12,7,5,106,48,58,88,56,32,53,56
Mon 26 Oct 2020 16:00,22,15,7,130,56,74,79,39,40,59,38
Mon 26 Oct 2020 17:00,12,8,4,118,55,63,70,39,31,75,37
Mon 26 Oct 2020 18:00,6,2,4,106,59,47,60,34,26,49,34
Mon 26 Oct 2020 19:00,3,1,2,83,45,38,40,23,17,39,16
Mon 26 Oct 2020 20:00,5,0,5,68,36,32,28,15,13,45,27
Mon 26 Oct 2020 21:00,3,3,0,31,19,12,17,8,9,21,12
Mon 26 Oct 2020 22:00,1,0,1,24,18,6,18,12,6,20,4
Mon 26 Oct 2020 23:00,2,1,1,12,8,4,6,3,3,14,7
Tue 27 Oct 2020 00:00,1,1,0,4,2,2,3,3,0,2,3
Tue 27 Oct 2020 01:00,0,0,0,3,3,0,2,1,1,3,1
Tue 27 Oct 2020 02:00,0,0,0,1,0,1,0,0,0,1,1
Tue 27 Oct 2020 03:00,0,0,0,2,2,0,1,1,0,1,0
Tue 27 Oct 2020 04:00,0,0,0,9,3,6,2,1,1,0,5
Tue 27 Oct 2020 05:00,1,1,0,22,2,20,8,8,0,4,12
Tue 27 Oct 2020 06:00,4,4,0,66,10,56,95,87,8,12,55
Tue 27 Oct 2020 07:00,15,14,1,183,53,130,88,78,10,23,88
Tue 27 Oct 2020 08:00,10,7,3,194,60,134,109,92,17,37,120
Tue 27 Oct 2020 09:00,6,5,1,85,20,65,56,47,9,16,78
Tue 27 Oct 2020 10:00,6,5,1,59,14,45,17,12,5,12,35
Tue 27 Oct 2020 11:00,9,7,2,76,32,44,44,33,11,29,37
Tue 27 Oct 2020 12:00,7,5,2,108,49,59,59,38,21,38,47
Tue 27 Oct 2020 13:00,7,5,2,110,57,53,62,36,26,44,28
Tue 27 Oct 2020 14:00,17,5,12,109,52,57,70,35,35,44,28
Tue 27 Oct 2020 15:00,6,4,2,93,44,49,65,27,38,73,39
Tue 27 Oct 2020 16:00,23,13,10,135,68,67,77,37,40,95,31
Tue 27 Oct 2020 17:00,15,7,8,251,137,114,114,51,63,167,38
Tue 27 Oct 2020 18:00,7,3,4,185,95,90,94,40,54,105,29
Tue 27 Oct 2020 19:00,5,2,3,89,51,38,48,19,29,77,11
Tue 27 Oct 2020 20:00,3,2,1,59,36,23,33,15,18,33,16
Tue 27 Oct 2020 21:00,1,0,1,22,14,8,19,9,10,14,7
Tue 27 Oct 2020 22:00,1,0,1,21,13,8,11,7,4,18,3
Tue 27 Oct 2020 23:00,2,2,0,23,15,8,11,6,5,8,2
Wed 28 Oct 2020 00:00,0,0,0,6,3,3,2,0,2,4,3
Wed 28 Oct 2020 01:00,1,1,0,4,2,2,2,2,0,0,1
Wed 28 Oct 2020 02:00,0,0,0,1,0,1,1,0,1,2,2
Wed 28 Oct 2020 03:00,0,0,0,5,3,2,1,1,0,1,0
Wed 28 Oct 2020 04:00,0,0,0,8,4,4,2,2,0,1,2
Wed 28 Oct 2020 05:00,2,2,0,19,0,19,13,13,0,2,10
Wed 28 Oct 2020 06:00,4,4,0,87,11,76,84,76,8,7,45
Wed 28 Oct 2020 07:00,7,7,0,166,53,113,97,86,11,30,116
Wed 28 Oct 2020 08:00,15,13,2,219,58,161,103,94,9,37,150
Wed 28 Oct 2020 09:00,11,8,3,112,31,81,60,50,10,35,73
Wed 28 Oct 2020 10:00,12,8,4,71,23,48,45,37,8,23,40
Wed 28 Oct 2020 11:00,15,11,4,83,30,53,58,38,20,31,32
Wed 28 Oct 2020 12:00,7,4,3,94,40,54,73,49,24,38,51
Wed 28 Oct 2020 13:00,9,4,5,92,42,50,67,39,28,64,35
Wed 28 Oct 2020 14:00,6,1,5,81,38,43,53,26,27,36,26
Wed 28 Oct 2020 15:00,15,5,10,108,61,47,48,25,23,47,25
Wed 28 Oct 2020 16:00,15,7,8,135,70,65,78,30,48,104,56
Wed 28 Oct 2020 17:00,16,9,7,239,128,111,102,43,59,126,27
Wed 28 Oct 2020 18:00,19,8,11,185,108,77,94,40,54,94,20
Wed 28 Oct 2020 19:00,6,2,4,109,63,46,48,29,19,60,25
Wed 28 Oct 2020 20:00,2,2,0,74,47,27,31,12,19,43,15
Wed 28 Oct 2020 21:00,3,1,2,47,21,26,24,11,13,27,6
Wed 28 Oct 2020 22:00,5,1,4,24,17,7,12,8,4,14,6
Wed 28 Oct 2020 23:00,1,0,1,19,12,7,10,6,4,14,0
Thu 29 Oct 2020 00:00,1,1,0,8,5,3,0,0,0,2,2
Thu 29 Oct 2020 01:00,0,0,0,0,0,0,1,1,0,0,2
Thu 29 Oct 2020 02:00,0,0,0,1,0,1,0,0,0,2,3
Thu 29 Oct 2020 03:00,0,0,0,3,2,1,1,1,0,0,0
Thu 29 Oct 2020 04:00,0,0,0,8,1,7,0,0,0,3,3
Thu 29 Oct 2020 05:00,0,0,0,24,3,21,10,9,1,1,10
Thu 29 Oct 2020 06:00,4,4,0,62,10,52,78,71,7,14,41
Thu 29 Oct 2020 07:00,10,9,1,142,32,110,75,65,10,13,68
Thu 29 Oct 2020 08:00,10,10,0,161,44,117,74,71,3,17,103
Thu 29 Oct 2020 09:00,7,5,2,81,22,59,44,38,6,11,36
Thu 29 Oct 2020 10:00,8,5,3,61,24,37,26,20,6,12,15
Thu 29 Oct 2020 11:00,7,4,3,73,31,42,32,23,9,20,17
Thu 29 Oct 2020 12:00,7,4,3,84,39,45,40,27,13,31,37
Thu 29 Oct 2020 13:00,8,4,4,109,41,68,44,32,12,36,32
Thu 29 Oct 2020 14:00,9,6,3,80,36,44,43,26,17,40,32
Thu 29 Oct 2020 15:00,9,7,2,95,49,46,52,34,18,64,34
Thu 29 Oct 2020 16:00,14,5,9,159,81,78,52,25,27,97,39
Thu 29 Oct 2020 17:00,10,4,6,218,119,99,75,33,42,116,44
Thu 29 Oct 2020 18:00,10,4,6,172,89,83,80,34,46,115,38
Thu 29 Oct 2020 19:00,7,4,3,131,70,61,54,34,20,63,22
Thu 29 Oct 2020 20:00,5,3,2,83,42,41,36,18,18,40,25
Thu 29 Oct 2020 21:00,5,3,2,39,25,14,19,8,11,31,12
Thu 29 Oct 2020 22:00,2,1,1,32,24,8,19,10,9,27,11
Thu 29 Oct 2020 23:00,2,2,0,22,16,6,5,4,1,4,7
Fri 30 Oct 2020 00:00,2,1,1,7,5,2,1,1,0,4,2
Fri 30 Oct 2020 01:00,0,0,0,3,1,2,1,1,0,4,4
Fri 30 Oct 2020 02:00,0,0,0,5,1,4,0,0,0,1,1
Fri 30 Oct 2020 03:00,0,0,0,4,2,2,1,1,0,2,0
Fri 30 Oct 2020 04:00,0,0,0,10,5,5,3,2,1,1,6
Fri 30 Oct 2020 05:00,1,1,0,22,0,22,10,9,1,2,10
Fri 30 Oct 2020 06:00,3,3,0,81,10,71,78,72,6,17,50
Fri 30 Oct 2020 07:00,10,9,1,158,45,113,96,80,16,17,89
Fri 30 Oct 2020 08:00,15,13,2,194,52,142,85,78,7,28,109
Fri 30 Oct 2020 09:00,7,6,1,111,31,80,58,46,12,17,66
Fri 30 Oct 2020 10:00,4,1,3,100,30,70,60,34,26,37,52
Fri 30 Oct 2020 11:00,11,6,5,119,42,77,68,42,26,38,30
Fri 30 Oct 2020 12:00,15,6,9,139,60,79,76,41,35,69,76
Fri 30 Oct 2020 13:00,13,9,4,157,66,91,88,48,40,81,65
Fri 30 Oct 2020 14:00,14,6,8,139,66,73,66,38,28,87,65
Fri 30 Oct 2020 15:00,12,8,4,166,75,91,123,71,52,95,70
Fri 30 Oct 2020 16:00,14,7,7,190,91,99,97,47,50,115,57
Fri 30 Oct 2020 17:00,14,5,9,265,142,123,119,62,57,153,42
Fri 30 Oct 2020 18:00,10,6,4,202,114,88,124,56,68,146,58
Fri 30 Oct 2020 19:00,7,5,2,144,67,77,71,37,34,101,46
Fri 30 Oct 2020 20:00,5,1,4,107,59,48,53,29,24,55,41
Fri 30 Oct 2020 21:00,7,7,0,81,45,36,45,24,21,42,16
Fri 30 Oct 2020 22:00,1,0,1,53,34,19,30,14,16,34,13
Fri 30 Oct 2020 23:00,4,2,2,31,18,13,15,8,7,13,10
Sat 31 Oct 2020 00:00,3,2,1,17,10,7,8,3,5,13,0
Sat 31 Oct 2020 01:00,0,0,0,6,5,1,2,2,0,6,3
Sat 31 Oct 2020 02:00,1,1,0,7,4,3,1,1,0,1,1
Sat 31 Oct 2020 03:00,0,0,0,6,5,1,1,0,1,3,0
Sat 31 Oct 2020 04:00,0,0,0,7,1,6,1,0,1,0,3
Sat 31 Oct 2020 05:00,1,1,0,11,3,8,3,2,1,2,2
Sat 31 Oct 2020 06:00,0,0,0,19,1,18,14,13,1,9,15
Sat 31 Oct 2020 07:00,1,1,0,41,9,32,20,20,0,4,18
Sat 31 Oct 2020 08:00,5,5,0,37,12,25,14,11,3,8,12
Sat 31 Oct 2020 09:00,6,5,1,43,14,29,20,19,1,22,16
Sat 31 Oct 2020 10:00,6,2,4,57,30,27,27,19,8,14,11
Sat 31 Oct 2020 11:00,9,5,4,69,20,49,31,17,14,29,24
Sat 31 Oct 2020 12:00,6,3,3,80,34,46,45,33,12,29,22
Sat 31 Oct 2020 13:00,16,7,9,105,54,51,46,29,17,53,37
Sat 31 Oct 2020 14:00,18,6,12,125,57,68,58,27,31,51,56
Sat 31 Oct 2020 15:00,14,8,6,108,59,49,50,25,25,50,17
Sat 31 Oct 2020 16:00,14,11,3,109,45,64,50,33,17,44,45
Sat 31 Oct 2020 17:00,7,4,3,112,56,56,75,45,30,46,39
Sat 31 Oct 2020 18:00,7,6,1,123,67,56,43,30,13,39,28
Sat 31 Oct 2020 19:00,6,1,5,85,44,41,27,18,9,52,24
Sat 31 Oct 2020 20:00,3,2,1,72,37,35,41,28,13,33,24
Sat 31 Oct 2020 21:00,4,1,3,46,20,26,31,13,18,30,20
Sat 31 Oct 2020 22:00,5,4,1,36,27,9,21,15,6,21,8
Sat 31 Oct 2020 23:00,2,1,1,17,9,8,20,9,11,21,8
